//MAP CONVERTED BY dmm2tgm.py THIS HEADER COMMENT PREVENTS RECONVERSION, DO NOT REMOVE
"bh" = (
/obj/structure/fluff/statue/knight/interior,
/turf/open/floor/rogue/hexstone,
/area/rogue/under/tomb/indoors)
"bz" = (
/obj/structure/table/wood/crafted,
/obj/item/rogueweapon/huntingknife/cleaver,
/turf/open/floor/rogue/herringbone,
/area/rogue/under/tomb/indoors)
"bD" = (
/obj/structure/fluff/statue/evil,
/turf/open/floor/rogue/hexstone,
/area/rogue/under/tomb/indoors)
"dw" = (
/obj/structure/closet/crate/chest,
/obj/effect/spawner/lootdrop/roguetown/dungeon/food,
/obj/effect/spawner/lootdrop/roguetown/dungeon/food,
/obj/effect/spawner/lootdrop/roguetown/dungeon/food,
/obj/effect/spawner/lootdrop/roguetown/dungeon/food,
/obj/effect/spawner/lootdrop/roguetown/dungeon/food,
/obj/effect/spawner/lootdrop/roguetown/dungeon/food,
/obj/effect/spawner/lootdrop/roguetown/dungeon/food,
/obj/effect/spawner/lootdrop/roguetown/dungeon/food,
/obj/effect/spawner/lootdrop/roguetown/dungeon/food,
/turf/open/floor/rogue/herringbone,
/area/rogue/under/tomb/indoors)
"gj" = (
/obj/structure/well,
/turf/open/floor/rogue/dirt,
/area/rogue/under/tomb)
"hf" = (
/obj/structure/roguewindow/openclose{
	dir = 4
	},
/turf/open/floor/rogue/herringbone,
/area/rogue/under/tomb/indoors)
"iJ" = (
/turf/open/floor/rogue/herringbone,
/area/rogue/under/tomb/indoors)
"jn" = (
/turf/open/floor/carpet/red,
/area/rogue/under/tomb/indoors)
"kG" = (
/obj/effect/dungeon_directional_helper/west,
/turf/open/floor/rogue/naturalstone,
/area/rogue/under/tomb)
"kO" = (
/turf/open/floor/rogue/hexstone,
/area/rogue/under/tomb/indoors)
"lo" = (
/obj/structure/bed/rogue/inn,
/obj/machinery/light/rogue/torchholder/c,
/turf/open/floor/rogue/herringbone,
/area/rogue/under/tomb/indoors)
"ls" = (
/obj/effect/spawner/lootdrop/roguetown/dungeon/food,
/obj/effect/spawner/lootdrop/roguetown/dungeon/food,
/obj/effect/spawner/lootdrop/roguetown/dungeon/food,
/obj/structure/table/church/m{
	icon_state = "churchtable_end"
	},
/turf/open/floor/rogue/hexstone,
/area/rogue/under/tomb/indoors)
"lU" = (
/turf/open/floor/rogue/dirt,
/area/rogue/under/tomb)
"mb" = (
/turf/open/transparent/openspace,
/area/rogue/under/tomb/indoors)
"mf" = (
/obj/machinery/light/rogue/torchholder/l,
/turf/open/floor/rogue/hexstone,
/area/rogue/under/tomb/indoors)
"mM" = (
/obj/machinery/light/rogue/firebowl,
/turf/open/floor/rogue/dirt,
/area/rogue/under/tomb)
"mT" = (
/turf/closed/mineral/rogue/bedrock,
/area/rogue/under/tomb)
"no" = (
/obj/structure/table/wood/crafted,
/obj/item/millstone,
/turf/open/floor/rogue/herringbone,
/area/rogue/under/tomb/indoors)
"ns" = (
/obj/structure/roguewindow/openclose,
/turf/open/floor/rogue/herringbone,
/area/rogue/under/tomb/indoors)
"nG" = (
/obj/structure/fermentation_keg/random/beer,
/turf/open/floor/rogue/herringbone,
/area/rogue/under/tomb/indoors)
"wE" = (
/obj/machinery/light/rogue/hearth,
/obj/item/cooking/pan,
/turf/open/floor/rogue/herringbone,
/area/rogue/under/tomb/indoors)
"yi" = (
/obj/structure/fluff/statue/knightalt,
/turf/open/floor/rogue/hexstone,
/area/rogue/under/tomb/indoors)
"yn" = (
/obj/machinery/light/rogue/firebowl,
/turf/open/floor/rogue/naturalstone,
/area/rogue/under/tomb)
"zz" = (
/obj/structure/closet/crate/chest,
/obj/item/seeds/wheat,
/obj/item/seeds/wheat,
/obj/item/seeds/wheat,
/obj/item/seeds/wheat,
/obj/item/seeds/wheat,
/obj/item/seeds/wheat,
/obj/item/seeds/wheat,
/obj/item/rogueweapon/hoe,
/obj/item/rogueweapon/sickle,
/obj/item/rogueweapon/thresher,
/obj/item/seeds/onion,
/obj/item/seeds/onion,
/obj/item/seeds/onion,
/obj/item/seeds/onion,
/obj/item/seeds/onion,
/obj/item/seeds/onion,
/obj/item/seeds/cabbage,
/obj/item/seeds/cabbage,
/obj/item/seeds/cabbage,
/obj/item/seeds/cabbage,
/obj/item/seeds/apple,
/obj/item/seeds/apple,
/obj/item/seeds/apple,
/turf/open/floor/rogue/dirt,
/area/rogue/under/tomb)
"AT" = (
/obj/structure/fermentation_keg/random/water,
/turf/open/floor/rogue/herringbone,
/area/rogue/under/tomb/indoors)
"Bv" = (
/obj/structure/table/church,
/obj/item/flashlight/flare/torch/metal{
	pixel_y = 7
	},
/obj/item/flashlight/flare/torch/metal{
	pixel_y = 6;
	pixel_x = -8
	},
/obj/item/flashlight/flare/torch/metal{
	pixel_x = 7;
	pixel_y = 6
	},
/turf/open/floor/rogue/hexstone,
/area/rogue/under/tomb/indoors)
"BZ" = (
/obj/machinery/light/rogue/oven/east,
/turf/open/floor/rogue/herringbone,
/area/rogue/under/tomb/indoors)
"Ca" = (
/obj/structure/closet/crate/chest/crafted,
/turf/open/floor/rogue/hexstone,
/area/rogue/under/tomb/indoors)
"Cn" = (
/obj/structure/stairs/stone{
	dir = 1
	},
/turf/open/floor/rogue/herringbone,
/area/rogue/under/tomb/indoors)
"Ef" = (
/obj/effect/dungeon_directional_helper/north,
/turf/open/floor/rogue/naturalstone,
/area/rogue/under/tomb)
"FY" = (
/obj/structure/dungeon_exit,
/turf/open/floor/rogue/herringbone,
/area/rogue/under/tomb/indoors)
"Gi" = (
/obj/structure/fluff/statue/knightalt/r,
/turf/open/floor/rogue/hexstone,
/area/rogue/under/tomb/indoors)
"GM" = (
/turf/open/floor/rogue/hexstone,
/area/rogue/under/tomb)
"Hl" = (
/obj/structure/roguewindow/openclose{
	dir = 1
	},
/turf/open/floor/rogue/herringbone,
/area/rogue/under/tomb/indoors)
"Hw" = (
/turf/closed/wall/mineral/rogue/stone,
/area/rogue/under/tomb/indoors)
"LD" = (
/obj/item/reagent_containers/glass/bucket,
/turf/open/floor/rogue/dirt,
/area/rogue/under/tomb)
"Ma" = (
/obj/effect/decal/cleanable/blood,
/turf/open/floor/rogue/hexstone,
/area/rogue/under/tomb/indoors)
"Mh" = (
/obj/structure/table/wood/crafted,
/turf/open/floor/rogue/herringbone,
/area/rogue/under/tomb/indoors)
"Mq" = (
/obj/structure/table/church/m,
/obj/item/reagent_containers/glass/bottle/waterskin{
	pixel_y = -1;
	pixel_x = -5
	},
/obj/item/reagent_containers/glass/bottle/waterskin{
	pixel_y = 3
	},
/obj/item/reagent_containers/glass/bottle/waterskin{
	pixel_x = 8;
	pixel_y = 7
	},
/turf/open/floor/rogue/hexstone,
/area/rogue/under/tomb/indoors)
"Oo" = (
/obj/machinery/light/rogue/firebowl,
/turf/open/floor/rogue/hexstone,
/area/rogue/under/tomb/indoors)
"OY" = (
/obj/structure/stairs/stone{
	dir = 1
	},
/turf/open/floor/rogue/hexstone,
/area/rogue/under/tomb/indoors)
"Pp" = (
/obj/machinery/light/rogue/hearth,
/obj/item/reagent_containers/glass/bucket/pot,
/turf/open/floor/rogue/herringbone,
/area/rogue/under/tomb/indoors)
"QX" = (
/obj/effect/dungeon_directional_helper/south,
/turf/open/floor/rogue/naturalstone,
/area/rogue/under/tomb)
"Re" = (
/obj/machinery/light/rogue/torchholder/c,
/turf/open/floor/rogue/herringbone,
/area/rogue/under/tomb/indoors)
"Rf" = (
/obj/structure/roguewindow/openclose{
	dir = 8
	},
/turf/open/floor/rogue/herringbone,
/area/rogue/under/tomb/indoors)
"RX" = (
/obj/structure/mineral_door/wood,
/turf/open/floor/rogue/herringbone,
/area/rogue/under/tomb/indoors)
"Sc" = (
/turf/open/transparent/openspace,
/area/rogue/under/tomb)
"Ve" = (
/obj/structure/closet/crate/drawer/inn,
/obj/item/clothing/suit/roguetown/shirt/tunic,
/turf/open/floor/rogue/herringbone,
/area/rogue/under/tomb/indoors)
"Vp" = (
/turf/open/floor/rogue/naturalstone,
/area/rogue/under/tomb)
"Xo" = (
/obj/structure/gate/preopen,
/turf/open/floor/rogue/hexstone,
/area/rogue/under/tomb/indoors)
"Xz" = (
/obj/structure/fluff/statue/knight/interior/r,
/turf/open/floor/rogue/hexstone,
/area/rogue/under/tomb/indoors)
"XC" = (
/obj/structure/closet/crate/drawer/inn,
/turf/open/floor/rogue/herringbone,
/area/rogue/under/tomb/indoors)

(1,1,1) = {"
mT
mT
mT
mT
mT
mT
mT
mT
mT
mT
mT
mT
mT
mT
Vp
Vp
kG
Vp
Vp
Vp
mT
mT
mT
mT
mT
mT
mT
mT
mT
mT
mT
mT
mT
mT
mT
"}
(2,1,1) = {"
mT
Vp
Vp
Vp
Vp
mT
mT
mT
Vp
Vp
Vp
Vp
Vp
Vp
Vp
Vp
Vp
Vp
Vp
Vp
Vp
Vp
Vp
Vp
Vp
Vp
Vp
mT
mT
mT
mT
mT
mT
mT
mT
"}
(3,1,1) = {"
mT
Vp
Vp
Vp
mT
mT
Vp
Vp
Vp
Vp
Vp
Vp
Vp
Vp
Vp
Vp
Vp
Vp
Vp
Vp
Vp
Vp
Vp
Vp
Vp
Vp
Vp
Vp
mT
mT
mT
mT
mT
mT
mT
"}
(4,1,1) = {"
mT
mT
Vp
mT
mT
Vp
Vp
Vp
Vp
lU
lU
lU
Vp
Vp
Vp
lU
Vp
Vp
Vp
Vp
lU
Vp
lU
Vp
lU
mM
lU
Vp
Vp
mT
mT
mT
mT
mT
Vp
"}
(5,1,1) = {"
mT
mT
Vp
Vp
Vp
Vp
Vp
Vp
lU
lU
lU
lU
lU
Vp
lU
lU
lU
Vp
Vp
lU
lU
lU
lU
lU
lU
lU
lU
Vp
Vp
Vp
mT
mT
mT
Vp
Vp
"}
(6,1,1) = {"
mT
mT
mT
Vp
Vp
Vp
Vp
Vp
lU
lU
lU
lU
lU
lU
lU
lU
lU
lU
lU
Hw
Hw
Hw
Hw
Hw
lU
lU
lU
lU
Vp
Vp
Vp
Vp
Vp
Vp
Vp
"}
(7,1,1) = {"
Vp
Vp
Vp
Vp
Vp
Vp
Vp
Vp
lU
lU
lU
Hw
Hw
Hw
Hw
Hw
lU
lU
lU
Hw
OY
kO
mf
Hw
zz
lU
lU
lU
lU
Vp
Vp
Vp
Vp
Vp
Vp
"}
(8,1,1) = {"
Vp
Vp
Vp
Vp
Vp
Vp
Vp
Vp
lU
lU
lU
Hw
Oo
kO
kO
Hw
Hw
Hw
Hw
Hw
OY
kO
kO
Hw
LD
lU
lU
lU
lU
Vp
Vp
Vp
Vp
Vp
QX
"}
(9,1,1) = {"
Vp
Vp
Vp
Vp
Vp
Vp
Vp
lU
lU
lU
lU
Hw
kO
kO
kO
bh
Oo
bh
kO
Hw
Hw
Hw
RX
Hw
lU
lU
lU
lU
lU
Vp
Vp
Vp
Vp
Vp
Vp
"}
(10,1,1) = {"
Ef
Vp
Vp
Vp
Vp
Vp
Vp
lU
lU
lU
lU
Hw
Ca
kO
kO
kO
kO
kO
kO
kO
kO
kO
kO
Hw
lU
lU
lU
lU
lU
Vp
Vp
Vp
Vp
Vp
Vp
"}
(11,1,1) = {"
Vp
Vp
Vp
Vp
Vp
Vp
Vp
lU
lU
lU
lU
Hw
yi
kO
Bv
kO
kO
kO
kO
jn
jn
jn
jn
Xo
GM
GM
GM
GM
lU
Vp
Vp
Vp
Vp
Vp
Vp
"}
(12,1,1) = {"
Vp
Vp
Vp
Vp
Vp
Vp
Vp
lU
lU
lU
lU
Hw
bD
kO
Mq
Ma
kO
kO
kO
jn
jn
jn
jn
kO
GM
GM
gj
GM
lU
Vp
Vp
Vp
Vp
Vp
Vp
"}
(13,1,1) = {"
Vp
Vp
Vp
Vp
Vp
Vp
Vp
lU
lU
lU
lU
Hw
Gi
kO
ls
kO
kO
kO
kO
jn
jn
jn
jn
kO
GM
GM
GM
GM
lU
Vp
Vp
Vp
Vp
Vp
mT
"}
(14,1,1) = {"
Vp
Vp
Vp
Vp
Vp
Vp
Vp
lU
lU
lU
lU
Hw
kO
kO
kO
kO
kO
kO
kO
kO
kO
kO
kO
Hw
lU
lU
lU
lU
lU
Vp
Vp
Vp
Vp
mT
mT
"}
(15,1,1) = {"
mT
mT
mT
mT
Vp
Vp
Vp
lU
lU
lU
lU
Hw
kO
kO
kO
Xz
Oo
Xz
kO
kO
kO
kO
kO
Hw
lU
lU
lU
lU
lU
Vp
Vp
Vp
mT
mT
mT
"}
(16,1,1) = {"
mT
mT
mT
mT
Vp
Vp
Vp
lU
lU
lU
lU
Hw
Oo
kO
kO
Hw
Hw
Hw
Hw
Hw
kO
kO
kO
Hw
lU
lU
lU
lU
lU
Vp
Vp
Vp
mT
mT
mT
"}
(17,1,1) = {"
mT
mT
mT
mT
mT
Vp
Vp
Vp
lU
lU
lU
Hw
Hw
Hw
Hw
Hw
lU
lU
lU
Hw
kO
kO
Oo
Hw
lU
lU
lU
lU
Vp
Vp
Vp
Vp
mT
mT
mT
"}
(18,1,1) = {"
mT
mT
mT
mT
mT
mT
Vp
Vp
lU
lU
lU
lU
lU
lU
lU
lU
lU
Vp
lU
Hw
Hw
Hw
Hw
Hw
lU
lU
lU
lU
Vp
Vp
mT
Vp
Vp
mT
mT
"}
(19,1,1) = {"
mT
mT
mT
mT
mT
mT
Vp
Vp
lU
lU
lU
lU
lU
lU
lU
lU
lU
Vp
Vp
lU
lU
lU
lU
lU
lU
lU
lU
Vp
Vp
Vp
mT
mT
Vp
mT
mT
"}
(20,1,1) = {"
mT
mT
mT
mT
mT
mT
Vp
Vp
Vp
lU
Vp
Vp
lU
lU
lU
lU
Vp
Vp
lU
lU
lU
Vp
lU
lU
lU
lU
Vp
Vp
Vp
Vp
Vp
mT
mT
mT
mT
"}
(21,1,1) = {"
mT
mT
mT
mT
mT
mT
mT
Vp
Vp
Vp
Vp
Vp
Vp
Vp
Vp
Vp
Vp
Vp
Vp
Vp
Vp
Vp
Vp
yn
Vp
Vp
Vp
Vp
mT
mT
Vp
mT
mT
mT
mT
"}
(22,1,1) = {"
mT
mT
mT
mT
mT
mT
mT
Vp
Vp
Vp
Vp
Vp
Vp
Vp
Vp
Vp
Vp
Vp
Vp
Vp
Vp
Vp
Vp
Vp
Vp
Vp
Vp
mT
mT
mT
mT
Vp
mT
mT
mT
"}
(23,1,1) = {"
mT
mT
mT
mT
mT
mT
mT
mT
Vp
Vp
Vp
Vp
Vp
Vp
Vp
Vp
Vp
Vp
Vp
Vp
Vp
mT
Vp
Vp
Vp
Vp
Vp
Vp
mT
mT
mT
Vp
Vp
mT
mT
"}
(24,1,1) = {"
mT
mT
mT
mT
mT
mT
mT
mT
mT
mT
mT
mT
mT
mT
Vp
Vp
Vp
Vp
mT
Vp
mT
mT
mT
mT
Vp
mT
Vp
Vp
mT
mT
mT
mT
mT
mT
mT
"}
(25,1,1) = {"
mT
mT
mT
mT
mT
mT
mT
mT
mT
mT
mT
mT
mT
mT
mT
mT
Vp
mT
mT
mT
mT
mT
mT
mT
mT
mT
mT
mT
mT
mT
mT
mT
mT
mT
mT
"}

(1,1,2) = {"
mT
mT
mT
mT
mT
mT
mT
mT
mT
mT
mT
mT
mT
mT
Sc
Sc
Sc
Sc
Sc
Sc
mT
mT
mT
mT
mT
mT
mT
mT
mT
mT
mT
mT
mT
mT
mT
"}
(2,1,2) = {"
mT
Sc
Sc
Sc
Sc
mT
mT
mT
Sc
Sc
Sc
Sc
Sc
Sc
Sc
Sc
Sc
Sc
Sc
Sc
Sc
Sc
Sc
Sc
Sc
Sc
Sc
mT
mT
mT
mT
mT
mT
mT
mT
"}
(3,1,2) = {"
mT
Sc
Sc
Sc
mT
mT
Sc
Sc
Sc
Sc
Sc
Sc
Sc
Sc
Sc
Sc
Sc
Sc
Sc
Sc
Sc
Sc
Sc
Sc
Sc
Sc
Sc
Sc
mT
mT
mT
mT
mT
mT
mT
"}
(4,1,2) = {"
mT
mT
Sc
mT
mT
Sc
Sc
Sc
Sc
Sc
Sc
Sc
Sc
Sc
Sc
Sc
Sc
Sc
Sc
Sc
Sc
Sc
Sc
Sc
Sc
Sc
Sc
Sc
Sc
mT
mT
mT
mT
mT
Sc
"}
(5,1,2) = {"
mT
mT
Sc
Sc
Sc
Sc
Sc
Sc
Sc
Sc
Sc
Sc
Sc
Sc
Sc
Sc
Sc
Sc
Sc
Sc
Sc
Sc
Sc
Sc
Sc
Sc
Sc
Sc
Sc
Sc
mT
mT
mT
Sc
Sc
"}
(6,1,2) = {"
mT
mT
mT
Sc
Sc
Sc
Sc
Sc
Sc
Sc
Sc
Hw
Hw
Hw
hf
Hw
Hw
Hw
Hw
Hw
Hw
Hw
Hw
Hw
Sc
Sc
Sc
Sc
Sc
Sc
Sc
Sc
Sc
Sc
Sc
"}
(7,1,2) = {"
Sc
Sc
Sc
Sc
Sc
Sc
Sc
Sc
Sc
Sc
Sc
Hw
Ve
iJ
iJ
iJ
Hw
Re
iJ
Cn
mb
nG
AT
Hw
Sc
Sc
Sc
Sc
Sc
Sc
Sc
Sc
Sc
Sc
Sc
"}
(8,1,2) = {"
Sc
Sc
Sc
Sc
Sc
Sc
Sc
Sc
Sc
Sc
Sc
ns
XC
iJ
iJ
iJ
Hw
iJ
iJ
Cn
mb
iJ
iJ
Hw
Sc
Sc
Sc
Sc
Sc
Sc
Sc
Sc
Sc
Sc
Sc
"}
(9,1,2) = {"
Sc
Sc
Sc
Sc
Sc
Sc
Sc
Sc
Sc
Sc
Sc
Hw
lo
iJ
iJ
iJ
RX
iJ
iJ
iJ
iJ
iJ
iJ
Hw
Sc
Sc
Sc
Sc
Sc
Sc
Sc
Sc
Sc
Sc
Sc
"}
(10,1,2) = {"
Sc
Sc
Sc
Sc
Sc
Sc
Sc
Sc
Sc
Sc
Sc
Hw
Hw
Hw
Hw
Hw
Hw
RX
Hw
Hw
Hw
Hw
Hw
Hw
Sc
Sc
Sc
Sc
Sc
Sc
Sc
Sc
Sc
Sc
Sc
"}
(11,1,2) = {"
Sc
Sc
Sc
Sc
Sc
Sc
Sc
Sc
Sc
Sc
Sc
Hw
Ve
iJ
iJ
iJ
Hw
Re
iJ
iJ
BZ
Pp
wE
Hw
Sc
Sc
Sc
Sc
Sc
Sc
Sc
Sc
Sc
Sc
Sc
"}
(12,1,2) = {"
Sc
Sc
Sc
Sc
Sc
Sc
Sc
Sc
Sc
Sc
Sc
ns
XC
iJ
iJ
iJ
RX
iJ
iJ
iJ
iJ
iJ
iJ
Hl
Sc
Sc
Sc
Sc
Sc
Sc
Sc
Sc
Sc
Sc
Sc
"}
(13,1,2) = {"
Sc
Sc
Sc
Sc
Sc
Sc
Sc
Sc
Sc
Sc
Sc
Hw
lo
iJ
iJ
iJ
Hw
Re
iJ
dw
no
Mh
bz
Hw
Sc
Sc
Sc
Sc
Sc
Sc
Sc
Sc
Sc
Sc
mT
"}
(14,1,2) = {"
Sc
Sc
Sc
Sc
Sc
Sc
Sc
Sc
Sc
Sc
Sc
Hw
Hw
Hw
Hw
Hw
Hw
RX
Hw
Hw
Hw
Hw
Hw
Hw
Sc
Sc
Sc
Sc
Sc
Sc
Sc
Sc
Sc
mT
mT
"}
(15,1,2) = {"
mT
mT
mT
mT
Sc
Sc
Sc
Sc
Sc
Sc
Sc
Hw
Ve
iJ
iJ
iJ
RX
iJ
iJ
iJ
iJ
iJ
iJ
Hw
Sc
Sc
Sc
Sc
Sc
Sc
Sc
Sc
mT
mT
mT
"}
(16,1,2) = {"
mT
mT
mT
mT
Sc
Sc
Sc
Sc
Sc
Sc
Sc
ns
XC
iJ
iJ
iJ
Hw
iJ
iJ
iJ
iJ
FY
iJ
Hw
Sc
Sc
Sc
Sc
Sc
Sc
Sc
Sc
mT
mT
mT
"}
(17,1,2) = {"
mT
mT
mT
mT
mT
Sc
Sc
Sc
Sc
Sc
Sc
Hw
lo
iJ
iJ
iJ
Hw
Re
iJ
iJ
iJ
iJ
iJ
Hw
Sc
Sc
Sc
Sc
Sc
Sc
Sc
Sc
mT
mT
mT
"}
(18,1,2) = {"
mT
mT
mT
mT
mT
mT
Sc
Sc
Sc
Sc
Sc
Hw
Hw
Hw
Rf
Hw
Hw
Hw
Hw
Hw
Hw
Hw
Hw
Hw
Sc
Sc
Sc
Sc
Sc
Sc
mT
Sc
Sc
mT
mT
"}
(19,1,2) = {"
mT
mT
mT
mT
mT
mT
Sc
Sc
Sc
Sc
Sc
Sc
Sc
Sc
Sc
Sc
Sc
Sc
Sc
Sc
Sc
Sc
Sc
Sc
Sc
Sc
Sc
Sc
Sc
Sc
mT
mT
Sc
mT
mT
"}
(20,1,2) = {"
mT
mT
mT
mT
mT
mT
Sc
Sc
Sc
Sc
Sc
Sc
Sc
Sc
Sc
Sc
Sc
Sc
Sc
Sc
Sc
Sc
Sc
Sc
Sc
Sc
Sc
Sc
Sc
Sc
Sc
mT
mT
mT
mT
"}
(21,1,2) = {"
mT
mT
mT
mT
mT
mT
mT
Sc
Sc
Sc
Sc
Sc
Sc
Sc
Sc
Sc
Sc
Sc
Sc
Sc
Sc
Sc
Sc
Sc
Sc
Sc
Sc
Sc
mT
mT
Sc
mT
mT
mT
mT
"}
(22,1,2) = {"
mT
mT
mT
mT
mT
mT
mT
Sc
Sc
Sc
Sc
Sc
Sc
Sc
Sc
Sc
Sc
Sc
Sc
Sc
Sc
Sc
Sc
Sc
Sc
Sc
Sc
mT
mT
mT
mT
Sc
mT
mT
mT
"}
(23,1,2) = {"
mT
mT
mT
mT
mT
mT
mT
mT
Sc
Sc
Sc
Sc
Sc
Sc
Sc
Sc
Sc
Sc
Sc
Sc
Sc
mT
Sc
Sc
Sc
Sc
Sc
Sc
mT
mT
mT
Sc
Sc
mT
mT
"}
(24,1,2) = {"
mT
mT
mT
mT
mT
mT
mT
mT
mT
mT
mT
mT
mT
mT
Sc
Sc
Sc
Sc
mT
Sc
mT
mT
mT
mT
Sc
mT
Sc
Sc
mT
mT
mT
mT
mT
mT
mT
"}
(25,1,2) = {"
mT
mT
mT
mT
mT
mT
mT
mT
mT
mT
mT
mT
mT
mT
mT
mT
Sc
mT
mT
mT
mT
mT
mT
mT
mT
mT
mT
mT
mT
mT
mT
mT
mT
mT
mT
"}
