//MAP CONVERTED BY dmm2tgm.py THIS HEADER COMMENT PREVENTS RECONVERSION, DO NOT REMOVE
"ao" = (
/obj/structure/bars,
/turf/open/floor/rogue/hexstone,
/area/rogue/under/tomb/indoors)
"aP" = (
/turf/open/transparent/openspace,
/area/rogue/under/tomb)
"bW" = (
/obj/structure/fluff/statue/evil,
/turf/open/floor/rogue/hexstone,
/area/rogue/under/tomb/indoors)
"cH" = (
/obj/structure/stairs/stone{
	dir = 4
	},
/turf/open/floor/rogue/ruinedwood/spiral,
/area/rogue/under/tomb/indoors)
"dv" = (
/obj/structure/fluff/statue/knight/interior,
/turf/open/floor/rogue/naturalstone,
/area/rogue/under/tomb)
"ec" = (
/turf/open/floor/rogue/hexstone,
/area/rogue/under/tomb/indoors)
"fk" = (
/turf/closed/wall/mineral/rogue/stone/moss,
/area/rogue/under/tomb/indoors)
"fS" = (
/turf/closed/wall/mineral/rogue/tent,
/area/rogue/under/tomb)
"gj" = (
/obj/structure/roguetent,
/turf/open/floor/rogue/dirt,
/area/rogue/under/tomb/indoors)
"gA" = (
/obj/structure/fermentation_keg/random/beer,
/turf/open/floor/rogue/ruinedwood/spiral,
/area/rogue/under/tomb/indoors)
"hN" = (
/obj/structure/chair/stool/rogue,
/turf/open/floor/rogue/naturalstone,
/area/rogue/under/tomb)
"iL" = (
/turf/open/floor/carpet/red,
/area/rogue/under/tomb/indoors)
"iS" = (
/obj/structure/wallladder{
	dir = 1
	},
/turf/open/floor/rogue/dirt,
/area/rogue/under/tomb)
"iX" = (
/turf/closed/wall/mineral/rogue/stone/window/moss,
/area/rogue/under/tomb/indoors)
"jq" = (
/obj/structure/wallladder{
	dir = 1
	},
/turf/open/floor/rogue/naturalstone,
/area/rogue/under/tomb)
"kc" = (
/obj/structure/table/wood,
/turf/open/floor/rogue/ruinedwood/spiral,
/area/rogue/under/tomb/indoors)
"kU" = (
/obj/structure/table/church/m,
/obj/item/reagent_containers/glass/bottle/waterskin{
	pixel_y = -1;
	pixel_x = -5
	},
/obj/item/reagent_containers/glass/bottle/waterskin{
	pixel_y = 3
	},
/obj/item/reagent_containers/glass/bottle/waterskin{
	pixel_x = 8;
	pixel_y = 7
	},
/turf/open/floor/carpet/red,
/area/rogue/under/tomb/indoors)
"lm" = (
/obj/structure/fermentation_keg,
/turf/open/floor/rogue/hexstone,
/area/rogue/under/tomb/indoors)
"ln" = (
/obj/structure/lever/wall{
	dir = 8;
	redstone_id = "northgatematt"
	},
/turf/open/floor/rogue/hexstone,
/area/rogue/under/tomb/indoors)
"ms" = (
/obj/structure/stairs/stone{
	dir = 1
	},
/turf/open/floor/rogue/dirt,
/area/rogue/under/tomb)
"nF" = (
/obj/structure/table/wood{
	dir = 1
	},
/obj/structure/bars/pipe,
/turf/open/floor/rogue/ruinedwood/spiral,
/area/rogue/under/tomb/indoors)
"nP" = (
/obj/structure/fluff/railing/border{
	dir = 4
	},
/turf/open/floor/rogue/ruinedwood/spiral,
/area/rogue/under/tomb)
"og" = (
/turf/open/floor/rogue/ruinedwood/spiral,
/area/rogue/under/tomb/indoors)
"or" = (
/turf/open/floor/rogue/ruinedwood/spiral,
/area/rogue/under/tomb)
"ow" = (
/obj/structure/fluff/railing/border,
/obj/structure/table/wood,
/obj/item/reagent_containers/glass/cup/skull,
/turf/open/floor/rogue/ruinedwood/spiral,
/area/rogue/under/tomb/indoors)
"pD" = (
/obj/structure/bed/rogue/shit,
/turf/open/floor/rogue/naturalstone,
/area/rogue/under/tomb/indoors)
"qj" = (
/turf/closed/wall/mineral/rogue/tent,
/area/rogue/under/tomb/indoors)
"qm" = (
/obj/structure/fermentation_keg/random/water,
/turf/open/floor/rogue/hexstone,
/area/rogue/under/tomb/indoors)
"qu" = (
/turf/open/floor/rogue/hexstone,
/area/rogue/under/tomb)
"qH" = (
/obj/structure/fluff/railing/border,
/obj/structure/chair/stool/rogue,
/turf/open/floor/rogue/ruinedwood/spiral,
/area/rogue/under/tomb/indoors)
"qO" = (
/turf/open/floor/rogue/naturalstone,
/area/rogue/under/tomb/cave)
"ry" = (
/obj/structure/chair/stool/rogue,
/turf/open/floor/rogue/dirt,
/area/rogue/under/tomb)
"rX" = (
/obj/structure/rack/rogue/shelf/biggest,
/obj/item/reagent_containers/glass/cup/wooden{
	pixel_y = -7
	},
/obj/item/reagent_containers/glass/cup/wooden{
	pixel_x = -5;
	pixel_y = 12
	},
/obj/item/reagent_containers/glass/cup/wooden{
	pixel_x = 8;
	pixel_y = 10
	},
/turf/open/floor/rogue/ruinedwood/spiral,
/area/rogue/under/tomb/indoors)
"sx" = (
/obj/machinery/light/rogue/campfire/longlived,
/turf/open/floor/rogue/naturalstone,
/area/rogue/under/tomb)
"tF" = (
/obj/item/chair/stool/bar/rogue/crafted,
/turf/open/floor/rogue/ruinedwood/spiral,
/area/rogue/under/tomb/indoors)
"tZ" = (
/obj/structure/table/wood,
/obj/structure/bars/pipe,
/turf/open/floor/rogue/ruinedwood/spiral,
/area/rogue/under/tomb/indoors)
"uR" = (
/obj/structure/closet/crate/drawer/inn,
/turf/open/floor/rogue/ruinedwood/spiral,
/area/rogue/under/tomb/indoors)
"vm" = (
/obj/machinery/light/rogue/torchholder/r,
/turf/open/floor/rogue/hexstone,
/area/rogue/under/tomb)
"wj" = (
/turf/closed/mineral/rogue,
/area/rogue/under/tomb/indoors)
"yl" = (
/obj/structure/table/church,
/obj/item/flashlight/flare/torch/metal{
	pixel_y = 7
	},
/obj/item/flashlight/flare/torch/metal{
	pixel_y = 6;
	pixel_x = -8
	},
/obj/item/flashlight/flare/torch/metal{
	pixel_x = 7;
	pixel_y = 6
	},
/turf/open/floor/carpet/red,
/area/rogue/under/tomb/indoors)
"yJ" = (
/obj/structure/stairs/stone{
	dir = 1
	},
/turf/open/floor/rogue/ruinedwood/spiral,
/area/rogue/under/tomb/indoors)
"AF" = (
/turf/open/floor/rogue/naturalstone,
/area/rogue/under/tomb)
"Bx" = (
/obj/structure/fluff/railing/border{
	dir = 8
	},
/obj/structure/fluff/railing/border{
	dir = 8
	},
/turf/open/floor/rogue/ruinedwood/spiral,
/area/rogue/under/tomb)
"BU" = (
/obj/structure/fermentation_keg/random/water,
/turf/open/floor/rogue/ruinedwood/spiral,
/area/rogue/under/tomb/indoors)
"Cq" = (
/obj/structure/mineral_door/bars,
/turf/open/floor/rogue/hexstone,
/area/rogue/under/tomb/indoors)
"DC" = (
/obj/structure/mineral_door/wood/deadbolt{
	dir = 4
	},
/turf/open/floor/rogue/ruinedwood/spiral,
/area/rogue/under/tomb/indoors)
"DE" = (
/obj/structure/rack/rogue/shelf/biggest,
/turf/open/floor/rogue/ruinedwood/spiral,
/area/rogue/under/tomb/indoors)
"Eh" = (
/obj/structure/roguetent,
/turf/open/floor/rogue/naturalstone,
/area/rogue/under/tomb/indoors)
"Fj" = (
/obj/structure/bed/rogue/inn,
/turf/open/floor/rogue/ruinedwood/spiral,
/area/rogue/under/tomb/indoors)
"Hd" = (
/obj/effect/dungeon_directional_helper/east,
/turf/open/floor/rogue/hexstone,
/area/rogue/under/tomb)
"HF" = (
/turf/closed/wall/mineral/rogue/wooddark,
/area/rogue/under/tomb)
"HL" = (
/turf/closed/wall/mineral/rogue/stone/window,
/area/rogue/under/tomb/indoors)
"JW" = (
/obj/structure/fluff/railing/border{
	dir = 8
	},
/turf/open/floor/rogue/ruinedwood/spiral,
/area/rogue/under/tomb)
"Ki" = (
/obj/structure/fluff/railing/border{
	dir = 8
	},
/turf/open/floor/rogue/ruinedwood/spiral,
/area/rogue/under/tomb/indoors)
"KN" = (
/obj/structure/fluff/railing/border{
	dir = 1
	},
/turf/open/floor/rogue/ruinedwood/spiral,
/area/rogue/under/tomb)
"Lg" = (
/obj/structure/fluff/railing/border,
/turf/open/floor/rogue/ruinedwood/spiral,
/area/rogue/under/tomb/indoors)
"LA" = (
/obj/structure/stairs/stone{
	dir = 4
	},
/turf/open/floor/rogue/naturalstone,
/area/rogue/under/tomb)
"LI" = (
/turf/closed/mineral/rogue/bedrock,
/area/rogue/under/tomb/cave)
"MU" = (
/obj/structure/table/wood,
/turf/open/floor/rogue/hexstone,
/area/rogue/under/tomb/indoors)
"NH" = (
/obj/structure/table/wood,
/obj/machinery/light/rogue/torchholder/r,
/turf/open/floor/rogue/hexstone,
/area/rogue/under/tomb/indoors)
"OY" = (
/obj/machinery/light/rogue/firebowl,
/turf/open/floor/rogue/ruinedwood/spiral,
/area/rogue/under/tomb/indoors)
"Pm" = (
/turf/open/floor/rogue/dirt,
/area/rogue/under/tomb/cave)
"PA" = (
/obj/structure/fermentation_keg/random/beer,
/turf/open/floor/rogue/hexstone,
/area/rogue/under/tomb/indoors)
"QQ" = (
/obj/structure/wallladder{
	dir = 4
	},
/turf/open/floor/rogue/dirt,
/area/rogue/under/tomb)
"QX" = (
/turf/open/floor/rogue/dirt,
/area/rogue/under/tomb)
"Rl" = (
/turf/open/transparent/openspace,
/area/rogue/under/tomb/cave)
"RK" = (
/obj/structure/dungeon_exit,
/turf/open/floor/rogue/ruinedwood/spiral,
/area/rogue/under/tomb/indoors)
"RY" = (
/obj/effect/dungeon_directional_helper/west,
/turf/open/floor/rogue/hexstone,
/area/rogue/under/tomb)
"Sz" = (
/obj/item/chair/stool/bar/rogue/crafted,
/turf/open/floor/rogue/naturalstone,
/area/rogue/under/tomb)
"Td" = (
/obj/structure/fluff/statue/knight/interior/r,
/turf/open/floor/rogue/naturalstone,
/area/rogue/under/tomb)
"Tj" = (
/obj/machinery/light/rogue/torchholder/r,
/turf/open/floor/rogue/ruinedwood/spiral,
/area/rogue/under/tomb/indoors)
"TF" = (
/obj/machinery/light/rogue/torchholder/l,
/turf/open/floor/rogue/hexstone,
/area/rogue/under/tomb/indoors)
"Ua" = (
/obj/machinery/light/rogue/firebowl,
/turf/open/floor/rogue/hexstone,
/area/rogue/under/tomb/indoors)
"Ut" = (
/obj/structure/chair/stool/rogue,
/turf/open/floor/rogue/ruinedwood/spiral,
/area/rogue/under/tomb/indoors)
"Vd" = (
/obj/structure/mineral_door/wood/deadbolt,
/turf/open/floor/rogue/ruinedwood/spiral,
/area/rogue/under/tomb/indoors)
"VQ" = (
/obj/structure/bed/rogue/shit,
/turf/open/floor/rogue/hexstone,
/area/rogue/under/tomb/indoors)
"WC" = (
/obj/structure/fluff/statue/knightalt,
/turf/open/floor/rogue/hexstone,
/area/rogue/under/tomb/indoors)
"XD" = (
/obj/structure/gate{
	redstone_id = "northgatematt"
	},
/turf/open/floor/rogue/hexstone,
/area/rogue/under/tomb/indoors)
"Yk" = (
/obj/machinery/light/rogue/torchholder/l,
/turf/open/floor/rogue/hexstone,
/area/rogue/under/tomb)
"YE" = (
/obj/structure/fluff/statue/knightalt/r,
/turf/open/floor/rogue/hexstone,
/area/rogue/under/tomb/indoors)
"Zl" = (
/obj/structure/table/church{
	dir = 1
	},
/obj/effect/spawner/lootdrop/roguetown/dungeon/food,
/obj/effect/spawner/lootdrop/roguetown/dungeon/food,
/obj/effect/spawner/lootdrop/roguetown/dungeon/food,
/turf/open/floor/carpet/red,
/area/rogue/under/tomb/indoors)
"ZN" = (
/obj/effect/dungeon_directional_helper/south,
/turf/open/floor/rogue/hexstone,
/area/rogue/under/tomb)

(1,1,1) = {"
LI
LI
LI
LI
LI
LI
LI
LI
LI
LI
LI
LI
LI
AF
AF
AF
HF
qu
RY
HF
QX
LI
LI
LI
LI
"}
(2,1,1) = {"
LI
LI
LI
LI
LI
LI
LI
LI
LI
LI
LI
LI
LI
QX
QX
AF
HF
qu
qu
HF
iS
LI
LI
LI
LI
"}
(3,1,1) = {"
LI
LI
LI
LI
LI
LI
LI
LI
LI
LI
LI
LI
LI
QX
QX
AF
QX
qu
qu
QX
QX
LI
LI
LI
LI
"}
(4,1,1) = {"
LI
LI
LI
LI
LI
LI
LI
LI
LI
LI
LI
LI
AF
AF
AF
AF
QX
qu
qu
QX
QX
LI
LI
LI
LI
"}
(5,1,1) = {"
LI
LI
LI
LI
LI
LI
LI
LI
LI
LI
LI
AF
qj
qj
qj
QX
QX
qu
qu
QX
QX
Pm
Pm
Pm
LI
"}
(6,1,1) = {"
LI
LI
LI
LI
LI
LI
LI
LI
LI
LI
AF
AF
qj
pD
gj
AF
QX
qu
qu
QX
QX
LI
qO
LI
LI
"}
(7,1,1) = {"
LI
LI
LI
LI
LI
LI
LI
LI
LI
LI
LI
AF
qj
qj
qj
AF
QX
qu
qu
QX
AF
LI
qO
LI
LI
"}
(8,1,1) = {"
LI
LI
LI
LI
LI
LI
LI
LI
LI
LI
LI
AF
AF
AF
QX
AF
QX
qu
qu
QX
QX
LI
LI
LI
LI
"}
(9,1,1) = {"
LI
LI
LI
LI
LI
LI
LI
LI
LI
LI
AF
QX
qj
qj
qj
QX
QX
qu
qu
QX
AF
qO
qO
LI
LI
"}
(10,1,1) = {"
LI
LI
LI
LI
LI
LI
LI
LI
LI
LI
AF
AF
qj
pD
Eh
AF
QX
qu
qu
QX
QX
LI
Pm
LI
LI
"}
(11,1,1) = {"
LI
LI
LI
LI
LI
LI
LI
LI
AF
Sz
AF
AF
qj
qj
qj
AF
QX
qu
qu
QX
QX
LI
qO
qO
LI
"}
(12,1,1) = {"
LI
LI
LI
LI
LI
LI
LI
AF
AF
AF
AF
QX
QX
QX
AF
QX
QX
qu
qu
QX
QX
LI
LI
qO
LI
"}
(13,1,1) = {"
LI
LI
LI
LI
LI
LI
AF
AF
LA
LA
AF
AF
AF
AF
AF
AF
QX
qu
qu
QX
QX
AF
LI
LI
LI
"}
(14,1,1) = {"
LI
LI
LI
LI
wj
fk
fk
fk
wj
wj
fk
fk
fk
QX
QX
AF
QX
qu
qu
QX
QX
AF
LI
LI
LI
"}
(15,1,1) = {"
LI
LI
LI
LI
wj
TF
ec
ec
ec
TF
ec
ec
wj
AF
QX
QX
QX
qu
qu
QX
QX
AF
AF
LI
LI
"}
(16,1,1) = {"
LI
LI
LI
LI
fk
ec
ec
ec
ec
ec
ec
ec
fk
AF
QX
QX
QX
qu
qu
QX
QX
QX
QX
AF
LI
"}
(17,1,1) = {"
LI
LI
LI
LI
fk
NH
VQ
MU
VQ
NH
VQ
ec
fk
AF
QX
QX
QX
qu
qu
QX
QX
AF
AF
AF
AF
"}
(18,1,1) = {"
LI
LI
LI
LI
wj
wj
fk
fk
wj
fk
wj
Cq
fk
fk
fk
fk
QX
qu
qu
QX
AF
AF
QX
AF
AF
"}
(19,1,1) = {"
LI
LI
LI
LI
fk
Ua
ec
ec
ec
ec
ec
ec
fk
ln
ec
wj
ms
qu
qu
QX
AF
AF
QX
AF
AF
"}
(20,1,1) = {"
LI
LI
LI
LI
wj
ec
ec
ec
ec
ec
ec
ec
Cq
ec
ec
fk
ms
qu
qu
QX
QX
QX
QX
QQ
QX
"}
(21,1,1) = {"
LI
LI
LI
LI
fk
ec
ec
ec
ec
ec
ec
ec
fk
ao
ao
fk
dv
qu
qu
QX
QX
QX
QX
HF
HF
"}
(22,1,1) = {"
LI
LI
LI
LI
fk
WC
iL
yl
iL
iL
iL
ec
XD
qu
qu
Yk
qu
qu
qu
qu
qu
qu
qu
qu
qu
"}
(23,1,1) = {"
LI
LI
LI
LI
fk
bW
iL
kU
iL
iL
iL
ec
ec
qu
qu
qu
qu
qu
qu
qu
qu
qu
qu
qu
ZN
"}
(24,1,1) = {"
LI
LI
LI
LI
fk
YE
iL
Zl
iL
iL
iL
ec
ec
qu
qu
vm
qu
qu
qu
qu
qu
qu
qu
qu
qu
"}
(25,1,1) = {"
LI
LI
LI
LI
wj
ec
ec
ec
ec
ec
ec
ec
fk
ao
ao
fk
Td
qu
qu
QX
QX
QX
QX
HF
HF
"}
(26,1,1) = {"
LI
LI
LI
LI
wj
ec
ec
ec
ec
ec
ec
ec
Cq
ec
ec
wj
QX
qu
qu
QX
AF
AF
AF
AF
AF
"}
(27,1,1) = {"
LI
LI
LI
LI
fk
Ua
ec
ec
ec
ec
ec
ec
wj
ec
ec
fk
QX
qu
qu
QX
AF
QX
QX
QX
AF
"}
(28,1,1) = {"
LI
LI
LI
LI
fk
wj
fk
fk
fk
fk
wj
Cq
fk
fk
fk
fk
QX
qu
qu
QX
AF
AF
QX
AF
AF
"}
(29,1,1) = {"
LI
LI
LI
LI
wj
qm
qm
qm
qm
ec
ec
ec
fk
AF
AF
AF
QX
qu
qu
QX
QX
QX
AF
LI
LI
"}
(30,1,1) = {"
LI
LI
LI
LI
wj
ec
ec
ec
ec
ec
ec
ec
fk
qj
qj
qj
QX
qu
qu
QX
QX
QX
LI
qO
LI
"}
(31,1,1) = {"
LI
LI
LI
LI
wj
PA
lm
lm
PA
ec
ec
ec
wj
qj
pD
qj
QX
qu
qu
QX
AF
AF
qO
Pm
LI
"}
(32,1,1) = {"
LI
LI
LI
LI
wj
fk
fk
wj
fk
fk
wj
fk
fk
qj
Eh
qj
QX
qu
qu
QX
AF
LI
LI
qO
LI
"}
(33,1,1) = {"
LI
LI
LI
LI
LI
LI
LI
AF
qj
qj
qj
QX
AF
hN
AF
AF
QX
qu
qu
QX
AF
AF
qO
Pm
LI
"}
(34,1,1) = {"
LI
LI
LI
LI
LI
LI
LI
AF
qj
pD
Eh
QX
ry
sx
AF
QX
QX
qu
qu
QX
QX
AF
Pm
LI
LI
"}
(35,1,1) = {"
LI
LI
LI
LI
LI
LI
LI
LI
qj
qj
qj
AF
AF
AF
hN
AF
QX
qu
qu
QX
AF
AF
qO
qO
LI
"}
(36,1,1) = {"
LI
LI
LI
LI
LI
LI
LI
LI
LI
AF
AF
QX
qj
Eh
qj
AF
QX
qu
qu
QX
AF
LI
LI
LI
LI
"}
(37,1,1) = {"
LI
LI
LI
LI
LI
LI
LI
LI
LI
LI
AF
AF
qj
pD
qj
AF
QX
qu
qu
QX
AF
LI
LI
LI
LI
"}
(38,1,1) = {"
LI
LI
LI
LI
LI
LI
LI
LI
LI
LI
AF
AF
qj
qj
qj
AF
QX
qu
qu
QX
AF
LI
LI
LI
LI
"}
(39,1,1) = {"
LI
LI
LI
LI
LI
LI
LI
LI
LI
LI
LI
AF
AF
AF
AF
QX
QX
qu
qu
QX
AF
LI
LI
LI
LI
"}
(40,1,1) = {"
LI
LI
LI
LI
LI
LI
LI
LI
LI
LI
LI
AF
QX
QX
AF
AF
QX
qu
qu
QX
AF
LI
LI
LI
LI
"}
(41,1,1) = {"
LI
LI
LI
LI
LI
LI
LI
LI
LI
LI
LI
LI
AF
QX
QX
QX
QX
qu
qu
QX
AF
LI
LI
LI
LI
"}
(42,1,1) = {"
LI
LI
LI
LI
LI
LI
LI
LI
LI
LI
LI
LI
AF
AF
QX
AF
QX
qu
qu
QX
AF
LI
LI
LI
LI
"}
(43,1,1) = {"
LI
LI
LI
LI
LI
LI
LI
LI
LI
LI
LI
LI
LI
AF
AF
AF
QX
qu
qu
QX
AF
LI
LI
LI
LI
"}
(44,1,1) = {"
LI
LI
LI
LI
LI
LI
LI
LI
LI
LI
LI
LI
LI
QX
QX
AF
HF
qu
qu
HF
jq
LI
LI
LI
LI
"}
(45,1,1) = {"
LI
LI
LI
LI
LI
LI
LI
LI
LI
LI
LI
LI
LI
QX
QX
QX
HF
qu
Hd
HF
AF
LI
LI
LI
LI
"}

(1,1,2) = {"
LI
LI
LI
LI
LI
LI
LI
LI
LI
LI
LI
LI
LI
aP
aP
aP
or
or
or
or
aP
LI
LI
LI
LI
"}
(2,1,2) = {"
LI
LI
LI
LI
LI
LI
LI
LI
LI
LI
LI
LI
LI
aP
aP
aP
nP
nP
nP
nP
aP
LI
LI
LI
LI
"}
(3,1,2) = {"
LI
LI
LI
LI
LI
LI
LI
LI
LI
LI
LI
LI
LI
aP
aP
aP
aP
aP
aP
aP
aP
LI
LI
LI
LI
"}
(4,1,2) = {"
LI
LI
LI
LI
LI
LI
LI
LI
LI
LI
LI
LI
aP
aP
aP
aP
aP
aP
aP
aP
aP
LI
LI
LI
LI
"}
(5,1,2) = {"
LI
LI
LI
LI
LI
LI
LI
LI
LI
LI
LI
aP
fS
fS
fS
aP
aP
aP
aP
aP
aP
Rl
Rl
Rl
LI
"}
(6,1,2) = {"
LI
LI
LI
LI
LI
LI
LI
LI
LI
LI
aP
aP
fS
fS
fS
aP
aP
aP
aP
aP
aP
LI
Rl
LI
LI
"}
(7,1,2) = {"
LI
LI
LI
LI
LI
LI
LI
LI
LI
LI
LI
aP
fS
fS
fS
aP
aP
aP
aP
aP
aP
LI
Rl
LI
LI
"}
(8,1,2) = {"
LI
LI
LI
LI
LI
LI
LI
LI
LI
LI
LI
aP
aP
aP
aP
aP
aP
aP
aP
aP
aP
LI
LI
LI
LI
"}
(9,1,2) = {"
LI
LI
LI
LI
LI
LI
LI
LI
LI
LI
aP
aP
fS
fS
fS
aP
aP
aP
aP
aP
aP
Rl
Rl
LI
LI
"}
(10,1,2) = {"
LI
LI
LI
LI
LI
LI
LI
LI
LI
LI
aP
aP
fS
fS
fS
aP
aP
aP
aP
aP
aP
LI
LI
LI
LI
"}
(11,1,2) = {"
LI
LI
LI
LI
LI
LI
LI
LI
LI
LI
aP
aP
fS
fS
fS
aP
aP
aP
aP
aP
aP
LI
LI
LI
LI
"}
(12,1,2) = {"
LI
LI
LI
LI
LI
LI
LI
aP
aP
aP
aP
aP
aP
aP
aP
aP
aP
aP
aP
aP
aP
LI
LI
LI
LI
"}
(13,1,2) = {"
LI
LI
LI
LI
LI
LI
aP
aP
aP
aP
aP
aP
aP
aP
aP
aP
aP
aP
aP
aP
aP
aP
LI
LI
LI
"}
(14,1,2) = {"
wj
wj
wj
wj
wj
wj
HL
wj
cH
cH
wj
wj
wj
Ki
Ki
wj
aP
aP
aP
aP
aP
aP
LI
LI
LI
"}
(15,1,2) = {"
wj
og
OY
og
Ut
og
og
og
og
og
Ut
og
og
og
og
qH
aP
aP
aP
aP
aP
aP
LI
LI
LI
"}
(16,1,2) = {"
wj
og
og
og
kc
og
og
og
og
og
kc
og
og
og
og
ow
aP
aP
aP
aP
aP
aP
aP
aP
LI
"}
(17,1,2) = {"
wj
og
og
og
tF
og
Ut
og
og
og
og
og
OY
og
og
qH
aP
aP
aP
aP
aP
aP
aP
aP
aP
"}
(18,1,2) = {"
wj
og
og
og
og
og
kc
og
og
og
og
og
wj
wj
wj
wj
aP
aP
aP
aP
aP
aP
aP
aP
aP
"}
(19,1,2) = {"
wj
og
og
og
Ut
og
Ut
og
og
kc
og
og
og
og
og
yJ
aP
aP
aP
aP
aP
aP
aP
aP
aP
"}
(20,1,2) = {"
wj
og
og
og
kc
og
og
Ut
og
Ut
og
og
og
og
og
yJ
aP
aP
aP
aP
aP
aP
aP
aP
aP
"}
(21,1,2) = {"
wj
og
og
og
og
og
og
kc
og
og
tF
og
wj
HL
wj
wj
aP
aP
aP
aP
aP
aP
aP
KN
or
"}
(22,1,2) = {"
wj
og
og
og
og
og
og
og
og
og
og
og
Lg
aP
aP
aP
aP
aP
aP
aP
aP
aP
aP
KN
or
"}
(23,1,2) = {"
wj
RK
og
og
og
og
og
og
OY
og
og
og
Lg
aP
aP
aP
aP
aP
aP
aP
aP
aP
aP
KN
or
"}
(24,1,2) = {"
wj
og
og
og
og
og
og
og
og
og
og
og
Lg
aP
aP
aP
aP
aP
aP
aP
aP
aP
aP
KN
or
"}
(25,1,2) = {"
wj
og
og
nF
tZ
tZ
tZ
tZ
tZ
tZ
tZ
tZ
wj
HL
wj
wj
aP
aP
aP
aP
aP
aP
aP
KN
or
"}
(26,1,2) = {"
wj
og
og
wj
og
og
og
og
og
og
og
og
og
og
DE
wj
aP
aP
aP
aP
aP
aP
aP
aP
aP
"}
(27,1,2) = {"
wj
og
og
Vd
Tj
DE
DE
og
Tj
DE
DE
DE
DE
Tj
DE
wj
aP
aP
aP
aP
aP
aP
aP
aP
aP
"}
(28,1,2) = {"
wj
og
og
wj
wj
wj
wj
DC
wj
wj
wj
wj
wj
wj
wj
wj
aP
aP
aP
aP
aP
aP
aP
aP
aP
"}
(29,1,2) = {"
wj
og
og
wj
Fj
og
og
og
wj
rX
DE
DE
iX
aP
aP
aP
aP
aP
aP
aP
aP
aP
aP
LI
LI
"}
(30,1,2) = {"
wj
og
og
wj
uR
og
og
og
Vd
og
og
og
iX
fS
fS
fS
aP
aP
aP
aP
aP
aP
LI
Rl
LI
"}
(31,1,2) = {"
wj
og
og
wj
uR
og
og
og
HL
gA
BU
BU
iX
fS
fS
fS
aP
aP
aP
aP
aP
aP
LI
Rl
LI
"}
(32,1,2) = {"
wj
wj
wj
wj
wj
wj
wj
wj
HL
wj
wj
wj
wj
fS
aP
fS
aP
aP
aP
aP
aP
LI
LI
Rl
LI
"}
(33,1,2) = {"
LI
LI
LI
LI
LI
LI
LI
aP
fS
fS
fS
aP
aP
aP
aP
aP
aP
aP
aP
aP
aP
aP
Rl
Rl
LI
"}
(34,1,2) = {"
LI
LI
LI
LI
LI
LI
LI
aP
fS
fS
aP
aP
aP
aP
aP
aP
aP
aP
aP
aP
aP
aP
Rl
LI
LI
"}
(35,1,2) = {"
LI
LI
LI
LI
LI
LI
LI
LI
fS
fS
fS
aP
aP
aP
aP
aP
aP
aP
aP
aP
aP
aP
Rl
Rl
LI
"}
(36,1,2) = {"
LI
LI
LI
LI
LI
LI
LI
LI
LI
aP
aP
aP
fS
aP
fS
aP
aP
aP
aP
aP
aP
LI
LI
LI
LI
"}
(37,1,2) = {"
LI
LI
LI
LI
LI
LI
LI
LI
LI
LI
aP
aP
fS
fS
fS
aP
aP
aP
aP
aP
aP
LI
LI
LI
LI
"}
(38,1,2) = {"
LI
LI
LI
LI
LI
LI
LI
LI
LI
LI
aP
aP
fS
fS
fS
aP
aP
aP
aP
aP
aP
LI
LI
LI
LI
"}
(39,1,2) = {"
LI
LI
LI
LI
LI
LI
LI
LI
LI
LI
LI
aP
aP
aP
aP
aP
aP
aP
aP
aP
aP
LI
LI
LI
LI
"}
(40,1,2) = {"
LI
LI
LI
LI
LI
LI
LI
LI
LI
LI
LI
aP
aP
aP
aP
aP
aP
aP
aP
aP
aP
LI
LI
LI
LI
"}
(41,1,2) = {"
LI
LI
LI
LI
LI
LI
LI
LI
LI
LI
LI
LI
aP
aP
aP
aP
aP
aP
aP
aP
aP
LI
LI
LI
LI
"}
(42,1,2) = {"
LI
LI
LI
LI
LI
LI
LI
LI
LI
LI
LI
LI
aP
aP
aP
aP
aP
aP
aP
aP
aP
LI
LI
LI
LI
"}
(43,1,2) = {"
LI
LI
LI
LI
LI
LI
LI
LI
LI
LI
LI
LI
LI
aP
aP
aP
aP
aP
aP
aP
aP
LI
LI
LI
LI
"}
(44,1,2) = {"
LI
LI
LI
LI
LI
LI
LI
LI
LI
LI
LI
LI
LI
aP
aP
aP
JW
JW
Bx
JW
aP
LI
LI
LI
LI
"}
(45,1,2) = {"
LI
LI
LI
LI
LI
LI
LI
LI
LI
LI
LI
LI
LI
aP
aP
aP
or
or
or
or
aP
LI
LI
LI
LI
"}
