//MAP CONVERTED BY dmm2tgm.py THIS HEADER COMMENT PREVENTS RECONVERSION, DO NOT REMOVE
"a" = (
/obj/machinery/light/rogue/candle/r,
/turf/open/floor/rogue/hexstone,
/area/rogue/under/tomb/cave)
"b" = (
/obj/machinery/light/rogue/torchholder/r,
/turf/open/floor/rogue/blocks/paving/vert,
/area/rogue/under/tomb/sewer)
"d" = (
/mob/living/simple_animal/hostile/retaliate/rogue/troll/axe,
/obj/structure/fluff/nest,
/obj/item/alch/bone,
/obj/item/clothing/head/roguetown/helmet/heavy/dwarven,
/obj/item/rogueweapon/spear/billhook,
/obj/item/clothing/ring/topaz,
/obj/item/roguecoin/gold/pile,
/obj/item/roguecoin/silver/pile,
/obj/effect/decal/cleanable/blood/gibs,
/obj/effect/decal/remains/human,
/turf/open/floor/rogue/blocks/paving,
/area/rogue/under/tomb/sewer)
"g" = (
/turf/closed/wall/mineral/rogue/decostone/fluffstone,
/area/rogue/under/tomb/cave)
"m" = (
/obj/effect/spawner/lootdrop/roguetown/dungeon/weapons,
/obj/item/rogueweapon/shield/buckler/palloy,
/obj/effect/decal/remains/human,
/turf/open/floor/rogue/blocks/paving/vert,
/area/rogue/under/tomb/sewer)
"o" = (
/turf/open/floor/rogue/hexstone,
/area/rogue/under/tomb/cave)
"r" = (
/turf/closed/mineral/rogue,
/area/rogue/under/tomb/sewer)
"x" = (
/obj/item/rogueweapon/shield/tower,
/obj/item/clothing/cloak/tabard/devotee/dendor,
/obj/effect/decal/remains/human,
/turf/open/floor/rogue/blocks/paving,
/area/rogue/under/tomb/sewer)
"B" = (
/obj/structure/pillory,
/obj/item/natural/stone,
/obj/item/natural/stone,
/obj/item/natural/stone,
/obj/item/rope/chain,
/turf/open/floor/rogue/hexstone,
/area/rogue/under/tomb/cave)
"C" = (
/obj/item/natural/stone,
/turf/open/floor/rogue/hexstone,
/area/rogue/under/tomb/cave)
"D" = (
/obj/machinery/light/rogue/candle/l,
/obj/item/natural/stone,
/turf/open/floor/rogue/hexstone,
/area/rogue/under/tomb/cave)
"F" = (
/obj/machinery/light/rogue/torchholder/l,
/turf/open/floor/rogue/blocks/paving/vert,
/area/rogue/under/tomb/sewer)
"G" = (
/obj/structure/fluff/wallclock/vampire,
/obj/item/rogueweapon/whip/nagaika,
/turf/open/floor/rogue/hexstone,
/area/rogue/under/tomb/cave)
"I" = (
/obj/item/alch/bone,
/obj/item/natural/fur/rat,
/obj/effect/decal/remains/bigrat,
/turf/open/floor/rogue/blocks/paving/vert,
/area/rogue/under/tomb/sewer)
"O" = (
/obj/machinery/light/rogue/candle/l,
/turf/open/floor/rogue/hexstone,
/area/rogue/under/tomb/cave)
"Q" = (
/turf/open/floor/rogue/blocks/paving,
/area/rogue/under/tomb/sewer)
"V" = (
/turf/closed/mineral/rogue/bedrock,
/area/rogue/under/tomb/cave)
"W" = (
/turf/open/floor/rogue/blocks/paving/vert,
/area/rogue/under/tomb/sewer)
"X" = (
/obj/item/gun/ballistic/revolver/grenadelauncher/bow/recurve,
/obj/item/quiver/arrows,
/obj/item/clothing/suit/roguetown/armor/plate/elven_plate,
/obj/item/clothing/cloak/raincloak/green,
/obj/effect/decal/remains/human,
/turf/open/floor/rogue/blocks/paving,
/area/rogue/under/tomb/sewer)

(1,1,1) = {"
o
o
g
g
V
V
V
g
g
o
o
"}
(2,1,1) = {"
a
o
O
g
g
V
g
g
O
o
a
"}
(3,1,1) = {"
g
a
o
O
g
g
g
O
o
a
g
"}
(4,1,1) = {"
g
g
a
o
O
g
O
o
a
g
g
"}
(5,1,1) = {"
V
g
g
g
o
D
o
g
g
g
V
"}
(6,1,1) = {"
V
V
V
g
G
B
C
g
V
V
V
"}
(7,1,1) = {"
V
g
g
g
C
a
o
g
g
g
V
"}
(8,1,1) = {"
g
g
O
o
a
g
a
o
O
g
g
"}
(9,1,1) = {"
g
O
o
a
g
g
g
a
o
O
g
"}
(10,1,1) = {"
O
o
a
g
g
V
g
g
a
o
O
"}
(11,1,1) = {"
o
o
g
g
V
V
V
g
g
o
o
"}

(1,1,2) = {"
r
r
r
r
r
Q
r
r
r
r
r
"}
(2,1,2) = {"
W
F
W
W
W
Q
W
W
W
F
W
"}
(3,1,2) = {"
r
Q
r
x
r
Q
r
Q
r
Q
r
"}
(4,1,2) = {"
r
W
W
W
I
Q
W
W
W
W
r
"}
(5,1,2) = {"
r
Q
r
Q
r
Q
r
Q
r
Q
r
"}
(6,1,2) = {"
r
Q
W
Q
W
d
W
Q
W
X
r
"}
(7,1,2) = {"
r
Q
r
Q
r
Q
r
Q
r
Q
r
"}
(8,1,2) = {"
r
W
m
W
W
Q
W
W
I
W
r
"}
(9,1,2) = {"
r
Q
r
Q
r
Q
r
Q
r
Q
r
"}
(10,1,2) = {"
W
b
W
W
W
Q
W
W
W
b
W
"}
(11,1,2) = {"
r
r
r
r
r
Q
r
r
r
r
r
"}
