//MAP CONVERTED BY dmm2tgm.py THIS HEADER COMMENT PREVENTS RECONVERSION, DO NOT REMOVE
"ab" = (
/obj/structure/table/wood{
	icon_state = "longtable";
	dir = 8
	},
/turf/open/floor/rogue/ruinedwood/spiral,
/area/rogue/under/tomb/indoors)
"ai" = (
/obj/effect/dungeon_directional_helper/south,
/turf/open/floor/rogue/naturalstone,
/area/rogue/under/tomb)
"am" = (
/turf/open/floor/rogue/dirt/road,
/area/rogue/under/tomb)
"ao" = (
/turf/open/floor/rogue/naturalstone,
/area/rogue/under/tomb/cave)
"av" = (
/turf/closed/wall/mineral/rogue/wooddark,
/area/rogue/under/tomb/indoors)
"aw" = (
/turf/closed/mineral/rogue/bedrock,
/area/rogue/under/tomb/indoors)
"aA" = (
/turf/closed/mineral/rogue/bedrock,
/area/rogue/under/tomb/cave)
"aB" = (
/turf/open/floor/rogue/naturalstone,
/area/rogue/under/tomb)
"aF" = (
/obj/structure/ladder,
/turf/open/floor/rogue/ruinedwood/spiral,
/area/rogue/under/tomb/indoors)
"aH" = (
/turf/open/floor/rogue/ruinedwood/spiral,
/area/rogue/under/tomb/indoors)
"aR" = (
/obj/structure/fluff/railing/fence,
/turf/open/floor/rogue/dirt,
/area/rogue/under/tomb)
"aV" = (
/turf/open/floor/rogue/dirt,
/area/rogue/under/tomb)
"cP" = (
/mob/living/carbon/human/species/skeleton/npc/mediumspread,
/turf/open/floor/rogue/ruinedwood/spiral,
/area/rogue/under/tomb/indoors)
"dX" = (
/obj/structure/mineral_door/wood/violet,
/turf/open/floor/rogue/naturalstone,
/area/rogue/under/tomb/indoors)
"dY" = (
/obj/structure/rack/rogue,
/obj/item/rogueweapon/sword/iron{
	pixel_x = 10
	},
/obj/item/rogueweapon/sword/iron{
	pixel_x = 3
	},
/obj/item/rogueweapon/sword/iron{
	pixel_y = 3;
	pixel_x = -1
	},
/turf/open/floor/rogue/ruinedwood/spiral,
/area/rogue/under/tomb/indoors)
"fU" = (
/turf/open/floor/rogue/dirt,
/area/rogue/under/tomb/indoors)
"gn" = (
/obj/structure/table/wood{
	icon_state = "longtable_mid"
	},
/turf/open/floor/rogue/ruinedwood/spiral,
/area/rogue/under/tomb/indoors)
"iB" = (
/obj/structure/fluff/railing/border,
/turf/open/transparent/openspace,
/area/rogue/under/tomb)
"nA" = (
/mob/living/carbon/human/species/skeleton/npc/bogguard,
/turf/open/floor/rogue/ruinedwood/spiral,
/area/rogue/under/tomb/indoors)
"ow" = (
/turf/open/floor/rogue/ruinedwood/spiral,
/area/rogue/under/tomb)
"oP" = (
/obj/structure/fluff/railing/border{
	dir = 10
	},
/turf/open/transparent/openspace,
/area/rogue/under/tomb)
"qK" = (
/mob/living/carbon/human/species/skeleton/npc/mediumspread,
/turf/open/floor/rogue/dirt/road,
/area/rogue/under/tomb)
"rG" = (
/obj/item/bomb{
	pixel_x = 9;
	pixel_y = 17
	},
/obj/item/bomb{
	pixel_x = -1;
	pixel_y = 17
	},
/obj/structure/rack/rogue/shelf/big,
/turf/open/floor/rogue/ruinedwood/spiral,
/area/rogue/under/tomb/indoors)
"us" = (
/obj/effect/dungeon_directional_helper/east,
/turf/open/floor/rogue/naturalstone,
/area/rogue/under/tomb)
"uM" = (
/obj/effect/dungeon_directional_helper/north,
/turf/open/floor/rogue/naturalstone,
/area/rogue/under/tomb)
"uP" = (
/obj/structure/fluff/railing/border{
	dir = 9
	},
/turf/open/transparent/openspace,
/area/rogue/under/tomb)
"uU" = (
/mob/living/carbon/human/species/skeleton/npc/mediumspread,
/turf/open/floor/rogue/dirt,
/area/rogue/under/tomb)
"wK" = (
/obj/item/clothing/ring/silver,
/obj/structure/table/wood{
	icon_state = "longtable";
	dir = 4
	},
/turf/open/floor/rogue/ruinedwood/spiral,
/area/rogue/under/tomb/indoors)
"xt" = (
/mob/living/carbon/human/species/skeleton/npc/mediumspread,
/turf/open/floor/rogue/ruinedwood/spiral,
/area/rogue/under/tomb)
"xF" = (
/turf/open/transparent/openspace,
/area/rogue/under/tomb)
"yp" = (
/obj/structure/closet/crate/drawer/inn,
/obj/item/ingot/silver,
/turf/open/floor/rogue/ruinedwood/spiral,
/area/rogue/under/tomb/indoors)
"yK" = (
/obj/structure/mineral_door/wood/violet,
/turf/open/floor/rogue/ruinedwood/spiral,
/area/rogue/under/tomb/indoors)
"DZ" = (
/obj/effect/decal/cleanable/dirt/cobweb{
	dir = 8
	},
/turf/open/floor/rogue/ruinedwood/spiral,
/area/rogue/under/tomb/indoors)
"Eb" = (
/mob/living/carbon/human/species/skeleton/npc/hardspread,
/turf/open/floor/rogue/ruinedwood/spiral,
/area/rogue/under/tomb/indoors)
"Gc" = (
/obj/structure/fluff/railing/fence{
	dir = 4
	},
/turf/open/floor/rogue/dirt,
/area/rogue/under/tomb)
"HC" = (
/obj/structure/fluff/railing/border{
	dir = 1
	},
/turf/open/transparent/openspace,
/area/rogue/under/tomb)
"HZ" = (
/obj/structure/closet/crate/chest/crafted,
/obj/item/gun/ballistic/revolver/grenadelauncher/bow/longbow,
/obj/item/quiver/arrows,
/obj/item/flashlight/flare/torch/lantern,
/obj/effect/decal/cleanable/dirt/cobweb{
	dir = 8
	},
/turf/open/floor/rogue/ruinedwood/spiral,
/area/rogue/under/tomb/indoors)
"Is" = (
/obj/structure/fluff/buysign{
	desc = " Store Closed"
	},
/turf/open/floor/rogue/naturalstone,
/area/rogue/under/tomb)
"MY" = (
/turf/closed/mineral/rogue/bedrock,
/area/rogue/under/tomb)
"Oy" = (
/obj/structure/bed/rogue/inn/wool,
/obj/effect/decal/cleanable/dirt/cobweb/cobweb2,
/turf/open/floor/rogue/ruinedwood/spiral,
/area/rogue/under/tomb/indoors)
"SJ" = (
/obj/structure/closet/crate/drawer/inn,
/turf/open/floor/rogue/ruinedwood/spiral,
/area/rogue/under/tomb/indoors)
"Vl" = (
/obj/structure/rack/rogue,
/obj/effect/spawner/lootdrop/roguetown/dungeon/weapons,
/obj/effect/spawner/lootdrop/roguetown/dungeon/weapons,
/obj/item/rogueweapon/shield/tower,
/turf/open/floor/rogue/ruinedwood/spiral,
/area/rogue/under/tomb/indoors)
"Xi" = (
/obj/structure/rack/rogue,
/obj/item/clothing/under/roguetown/trou/leather{
	pixel_x = 14;
	pixel_y = -4
	},
/obj/item/clothing/wrists/roguetown/bracers/leather{
	pixel_y = -9;
	pixel_x = -6
	},
/obj/item/clothing/suit/roguetown/armor/leather/cuirass,
/turf/open/floor/rogue/ruinedwood/spiral,
/area/rogue/under/tomb/indoors)
"XJ" = (
/obj/structure/fluff/railing/border{
	dir = 8
	},
/turf/open/transparent/openspace,
/area/rogue/under/tomb)
"XS" = (
/turf/closed/wall/mineral/rogue/wooddark/window,
/area/rogue/under/tomb/indoors)
"Yx" = (
/obj/structure/fluff/railing/fence,
/turf/open/floor/rogue/naturalstone,
/area/rogue/under/tomb)

(1,1,1) = {"
aA
aA
aA
aA
aw
aw
aw
aw
aw
aw
aw
aA
aA
aA
aA
"}
(2,1,1) = {"
aA
ao
ao
ao
av
rG
dY
Vl
Xi
aF
av
ao
ao
ao
aA
"}
(3,1,1) = {"
aA
ao
ao
aA
av
aH
aH
cP
aH
aH
av
aA
ao
ao
aA
"}
(4,1,1) = {"
aA
ao
ao
aA
av
aH
wK
gn
gn
ab
av
aA
aA
ao
aA
"}
(5,1,1) = {"
aA
aA
ao
ao
av
aH
aH
aH
aH
DZ
av
aA
aA
ao
aA
"}
(6,1,1) = {"
aB
aB
aB
aB
av
fU
XS
dX
XS
av
av
aB
aB
aB
aB
"}
(7,1,1) = {"
aB
aB
aB
aV
aR
aV
aV
am
uU
aV
aR
aV
aV
aV
aB
"}
(8,1,1) = {"
uM
aB
aB
aV
am
am
am
am
am
am
am
am
am
aV
ai
"}
(9,1,1) = {"
aB
aB
aB
aV
aR
aV
uU
am
aV
aV
aR
aV
aV
aV
aB
"}
(10,1,1) = {"
aB
aB
Is
aB
Yx
aV
aV
qK
aV
uU
aR
aB
aB
aB
aB
"}
(11,1,1) = {"
aA
aA
aA
aA
aA
Gc
Gc
am
Gc
Gc
aA
aA
ao
aA
aA
"}
(12,1,1) = {"
aA
aA
aA
aA
ao
aB
aV
am
aV
aB
ao
aA
ao
aA
aA
"}
(13,1,1) = {"
aA
aA
ao
ao
ao
aB
aV
aV
aV
aB
ao
aA
ao
ao
aA
"}
(14,1,1) = {"
aA
aA
aA
ao
ao
aB
aB
aB
aB
aB
ao
aA
aA
aA
aA
"}
(15,1,1) = {"
aA
aA
aA
aA
aA
aB
aB
us
aB
aB
aA
aA
aA
aA
aA
"}

(1,1,2) = {"
aA
aA
aA
aA
aw
aw
aw
aw
aw
aw
aw
aA
aA
aA
aA
"}
(2,1,2) = {"
aA
ao
ao
ao
av
SJ
aH
aH
aH
aF
av
aA
ao
ao
aA
"}
(3,1,2) = {"
aA
ao
ao
ao
av
yp
Eb
aH
aH
aH
av
ao
ao
ao
aA
"}
(4,1,2) = {"
aA
ao
ao
aA
av
Oy
aH
aH
nA
HZ
av
aA
aA
ao
aA
"}
(5,1,2) = {"
aA
ao
aA
aA
av
av
XS
yK
XS
av
av
aA
aA
ao
aA
"}
(6,1,2) = {"
ao
ao
xF
iB
ow
ow
ow
xt
ow
ow
ow
HC
xF
ao
ao
"}
(7,1,2) = {"
aB
xF
xF
oP
XJ
XJ
XJ
xF
XJ
XJ
XJ
uP
xF
xF
aB
"}
(8,1,2) = {"
aB
xF
xF
xF
xF
xF
xF
xF
xF
xF
xF
xF
xF
xF
aB
"}
(9,1,2) = {"
aB
xF
xF
xF
xF
xF
xF
xF
xF
xF
xF
xF
xF
xF
aB
"}
(10,1,2) = {"
aB
xF
xF
xF
xF
xF
xF
xF
xF
xF
xF
xF
xF
xF
aB
"}
(11,1,2) = {"
MY
MY
MY
MY
MY
xF
xF
xF
xF
xF
MY
MY
xF
MY
MY
"}
(12,1,2) = {"
MY
MY
MY
MY
xF
xF
xF
xF
xF
xF
xF
xF
xF
MY
MY
"}
(13,1,2) = {"
MY
MY
xF
xF
xF
xF
xF
xF
xF
xF
xF
MY
xF
xF
MY
"}
(14,1,2) = {"
MY
MY
MY
xF
xF
xF
xF
xF
xF
xF
xF
MY
MY
MY
MY
"}
(15,1,2) = {"
MY
MY
MY
MY
MY
aB
aB
aB
aB
aB
MY
MY
MY
MY
MY
"}
