//MAP CONVERTED BY dmm2tgm.py THIS HEADER COMMENT PREVENTS RECONVERSION, DO NOT REMOVE
"aB" = (
/turf/closed/wall/mineral/rogue/stone,
/area/rogue/under/tomb/cave/wet)
"aL" = (
/obj/effect/decal/remains/human,
/turf/open/floor/rogue/cobble/mossy,
/area/rogue/under/tomb)
"aX" = (
/obj/structure/mineral_door/bars,
/turf/open/floor/rogue/grass,
/area/rogue/under/tomb/wilds)
"bF" = (
/obj/structure/trap/curse/hidden,
/turf/open/floor/rogue/cobblerock,
/area/rogue/under/tomb)
"bL" = (
/obj/item/restraints/legcuffs/beartrap/armed/camouflage,
/turf/open/floor/rogue/grass,
/area/rogue/under/tomb/wilds)
"bQ" = (
/obj/structure/table/wood,
/obj/item/book/granter/arcane_aspect/major{
	pixel_y = 11;
	pixel_x = 15
	},
/turf/open/floor/rogue/blocks/stonered,
/area/rogue/under/tomb/indoors/church)
"ci" = (
/mob/living/carbon/human/species/skeleton/npc/no_equipment,
/turf/open/floor/rogue/cobble,
/area/rogue/under/tomb)
"cD" = (
/turf/open/floor/rogue/cobble,
/area/rogue/under/tomb/cave/wet)
"dQ" = (
/obj/structure/mineral_door/wood/violet,
/turf/open/floor/rogue/cobble,
/area/rogue/under/tomb)
"el" = (
/obj/structure/table/wood{
	dir = 1
	},
/turf/open/floor/rogue/blocks/stonered,
/area/rogue/under/tomb/indoors/church)
"fs" = (
/obj/effect/decal/remains/cabbit,
/turf/open/floor/rogue/cobble,
/area/rogue/under/tomb/cave/wet)
"ft" = (
/turf/open/floor/rogue/cobble/mossy,
/area/rogue/under/tomb/cave/wet)
"gk" = (
/obj/structure/spider/stickyweb,
/obj/effect/decal/cleanable/blood/gibs,
/turf/open/floor/rogue/cobble,
/area/rogue/under/tomb)
"gm" = (
/obj/effect/decal/cleanable/blood/gibs/up,
/turf/open/floor/rogue/cobble/mossy,
/area/rogue/under/tomb)
"gn" = (
/obj/effect/decal/cleanable/blood/gibs/torso,
/turf/open/floor/rogue/cobble,
/area/rogue/under/tomb)
"ha" = (
/obj/structure/spider/stickyweb,
/obj/structure/closet/crate/chest/neu_fancy,
/obj/effect/spawner/lootdrop/roguetown/dungeon/weapons,
/turf/open/floor/rogue/cobble,
/area/rogue/under/tomb)
"hM" = (
/mob/living/carbon/human/species/skeleton/npc/bogguard,
/turf/open/floor/rogue/cobble,
/area/rogue/under/tomb)
"hQ" = (
/obj/effect/dungeon_directional_helper/south,
/turf/open/floor/rogue/cobble,
/area/rogue/under/tomb)
"in" = (
/obj/structure/closet/crate/chest/old_crate,
/obj/effect/spawner/lootdrop/roguetown/dungeon/spells,
/turf/open/floor/rogue/cobble,
/area/rogue/under/tomb/cave/wet)
"ip" = (
/obj/structure/spider/stickyweb,
/obj/effect/decal/cleanable/blood/footprints,
/turf/open/floor/rogue/cobble/mossy,
/area/rogue/under/tomb)
"iB" = (
/obj/machinery/light/rogue/firebowl,
/obj/structure/trap/fire,
/turf/open/floor/rogue/blocks/stonered/tiny,
/area/rogue/under/tomb/indoors/church)
"iC" = (
/obj/structure/trap/curse/hidden,
/turf/open/floor/rogue/cobble,
/area/rogue/under/tomb)
"jQ" = (
/obj/structure/closet/dirthole/closed,
/obj/structure/gravemarker,
/turf/open/floor/rogue/grass,
/area/rogue/under/tomb/wilds)
"jS" = (
/obj/structure/fluff/railing/wood,
/turf/open/floor/rogue/cobblerock,
/area/rogue/under/tomb)
"lK" = (
/obj/structure/closet/dirthole/closed/loot,
/obj/structure/gravemarker,
/turf/open/floor/rogue/grass,
/area/rogue/under/tomb/wilds)
"lX" = (
/obj/effect/decal/remains/human{
	pixel_x = 12
	},
/turf/open/floor/rogue/cobble/mossy,
/area/rogue/under/tomb)
"mw" = (
/obj/item/ash{
	pixel_x = -10
	},
/obj/item/ash{
	pixel_y = 6;
	pixel_x = 6
	},
/obj/item/ash{
	pixel_y = 6;
	pixel_x = 6
	},
/turf/open/floor/rogue/cobble,
/area/rogue/under/tomb)
"my" = (
/obj/structure/stairs/stone{
	dir = 8
	},
/turf/open/floor/rogue/blocks,
/area/rogue/under/tomb)
"nK" = (
/obj/structure/fluff/walldeco/stone,
/turf/closed/wall/mineral/rogue/stone,
/area/rogue/under/tomb)
"of" = (
/obj/structure/trap/fire,
/turf/open/floor/rogue/blocks/stonered,
/area/rogue/under/tomb/indoors/church)
"or" = (
/obj/effect/decal/cleanable/blood/gibs/core,
/turf/open/floor/rogue/cobble/mossy,
/area/rogue/under/tomb)
"pq" = (
/turf/open/floor/rogue/cobble,
/area/rogue/under/tomb)
"pB" = (
/obj/structure/flora/roguegrass/water/reeds,
/turf/open/water/swamp,
/area/rogue/under/tomb/cave/wet)
"pM" = (
/obj/structure/fluff/walldeco/chains,
/turf/closed/wall/mineral/rogue/stone,
/area/rogue/under/tomb/cave/wet)
"pZ" = (
/obj/effect/spawner/lootdrop/potion_stats,
/turf/open/floor/rogue/cobble/mossy,
/area/rogue/under/tomb)
"qe" = (
/obj/structure/fluff/walldeco/chains,
/turf/closed/wall/mineral/rogue/stone,
/area/rogue/under/tomb)
"qi" = (
/obj/item/clothing/ring/quartz,
/turf/open/floor/rogue/cobblerock,
/area/rogue/under/tomb)
"qk" = (
/obj/effect/decal/remains/human{
	pixel_y = 5
	},
/turf/open/floor/rogue/cobble,
/area/rogue/under/tomb)
"qz" = (
/turf/closed/wall/mineral/rogue/decostone/cand,
/area/rogue/under/tomb)
"qE" = (
/mob/living/simple_animal/hostile/retaliate/rogue/spider,
/turf/open/floor/rogue/cobble/mossy,
/area/rogue/under/tomb)
"sx" = (
/obj/structure/fluff/walldeco/chains,
/turf/open/floor/rogue/cobble,
/area/rogue/under/tomb)
"sR" = (
/obj/effect/decal/remains/human,
/turf/open/floor/rogue/cobble/mossy,
/area/rogue/under/tomb/cave/wet)
"sZ" = (
/obj/effect/decal/remains/bigrat,
/turf/open/water/swamp,
/area/rogue/under/tomb/cave/wet)
"tm" = (
/obj/structure/spider/stickyweb,
/turf/open/floor/rogue/cobble/mossy,
/area/rogue/under/tomb)
"tt" = (
/obj/structure/fluff/walldeco/chains,
/mob/living/carbon/human/species/skeleton/npc/mediumspread,
/turf/open/floor/rogue/cobble,
/area/rogue/under/tomb)
"tu" = (
/obj/structure/bars,
/turf/open/floor/rogue/cobble,
/area/rogue/under/tomb)
"tx" = (
/turf/open/floor/rogue/dirt,
/area/rogue/under/tomb/wilds)
"ug" = (
/turf/open/water/swamp,
/area/rogue/under/tomb/cave/wet)
"vk" = (
/obj/machinery/light/rogue/firebowl,
/turf/open/floor/rogue/blocks/stonered/tiny,
/area/rogue/under/tomb/indoors/church)
"vR" = (
/obj/structure/flora/roguegrass/bush,
/obj/structure/flora/roguegrass,
/turf/open/floor/rogue/grass,
/area/rogue/under/tomb/wilds)
"wx" = (
/obj/structure/closet/crate/chest/lootbox,
/obj/effect/spawner/lootdrop/general_loot_hi,
/turf/open/floor/rogue/cobble,
/area/rogue/under/tomb)
"wN" = (
/obj/structure/closet/crate/chest/neu_fancy,
/obj/effect/spawner/lootdrop/general_loot_mid,
/turf/open/floor/rogue/cobble,
/area/rogue/under/tomb)
"xd" = (
/obj/structure/flora/roguegrass/water,
/obj/item/restraints/legcuffs/beartrap/armed/camouflage,
/turf/open/floor/rogue/dirt,
/area/rogue/under/tomb/wilds)
"xg" = (
/obj/structure/fluff/statue/astrata,
/obj/structure/trap/fire,
/turf/open/floor/rogue/blocks/stonered,
/area/rogue/under/tomb/indoors/church)
"xp" = (
/obj/effect/spawner/lootdrop/general_loot_hi,
/turf/open/floor/rogue/cobble,
/area/rogue/under/tomb)
"xr" = (
/obj/effect/decal/cleanable/blood/footprints,
/turf/open/floor/rogue/cobble,
/area/rogue/under/tomb)
"yL" = (
/obj/effect/decal/remains/bigrat,
/turf/open/floor/rogue/cobble,
/area/rogue/under/tomb/cave/wet)
"yO" = (
/obj/effect/dungeon_directional_helper/west,
/turf/open/floor/rogue/cobble/mossy,
/area/rogue/under/tomb)
"yU" = (
/obj/effect/spawner/lootdrop/general_loot_low,
/turf/open/floor/rogue/cobble,
/area/rogue/under/tomb)
"zq" = (
/turf/open/transparent/openspace,
/area/rogue/under/tomb)
"zX" = (
/obj/effect/decal/remains/human,
/turf/open/floor/rogue/cobble,
/area/rogue/under/tomb)
"Ab" = (
/obj/structure/closet/dirthole/closed,
/obj/structure/gravemarker,
/obj/structure/flora/roguegrass,
/turf/open/floor/rogue/grass,
/area/rogue/under/tomb/wilds)
"Ay" = (
/obj/effect/spawner/roguemap/treeorstump,
/turf/open/floor/rogue/grass,
/area/rogue/under/tomb/wilds)
"Bb" = (
/obj/structure/flora/roguegrass/bush,
/turf/open/floor/rogue/grass,
/area/rogue/under/tomb/wilds)
"BH" = (
/obj/effect/dungeon_directional_helper/north,
/turf/open/floor/rogue/cobble,
/area/rogue/under/tomb)
"BO" = (
/obj/structure/flora/roguegrass,
/turf/open/floor/rogue/dirt,
/area/rogue/under/tomb/wilds)
"Cg" = (
/obj/item/restraints/legcuffs/beartrap/armed/camouflage,
/turf/open/floor/rogue/blocks,
/area/rogue/under/tomb)
"Co" = (
/turf/open/floor/rogue/blocks,
/area/rogue/under/tomb)
"CJ" = (
/obj/item/restraints/legcuffs/beartrap/armed/camouflage,
/turf/open/floor/rogue/dirt/road,
/area/rogue/under/tomb/wilds)
"Dp" = (
/obj/effect/decal/remains/bigrat,
/obj/structure/flora/roguegrass/water/reeds,
/turf/open/water/swamp,
/area/rogue/under/tomb/cave/wet)
"DZ" = (
/turf/open/floor/rogue/cobblerock,
/area/rogue/under/tomb)
"Em" = (
/obj/effect/dungeon_directional_helper/east,
/turf/open/floor/rogue/cobble/mossy,
/area/rogue/under/tomb)
"En" = (
/obj/structure/bars,
/turf/open/floor/rogue/cobble,
/area/rogue/under/tomb/cave/wet)
"ER" = (
/turf/open/floor/rogue/blocks/stonered/tiny,
/area/rogue/under/tomb/indoors/church)
"EY" = (
/obj/structure/flora/roguegrass,
/turf/closed/mineral/rogue/bedrock,
/area/rogue/under/tomb/wilds)
"Fq" = (
/obj/structure/flora/roguegrass,
/obj/item/restraints/legcuffs/beartrap/armed/camouflage,
/turf/open/floor/rogue/grass,
/area/rogue/under/tomb/wilds)
"FD" = (
/obj/effect/spawner/roguemap/treeorstump,
/turf/open/floor/rogue/dirt,
/area/rogue/under/tomb/wilds)
"Gi" = (
/obj/structure/trap/chill,
/turf/open/floor/rogue/cobble,
/area/rogue/under/tomb)
"HP" = (
/obj/structure/mineral_door/bars,
/turf/open/floor/rogue/cobble,
/area/rogue/under/tomb)
"Ic" = (
/obj/structure/trap/shock,
/turf/open/floor/rogue/cobble,
/area/rogue/under/tomb)
"Ir" = (
/obj/effect/decal/remains/human,
/obj/effect/spawner/lootdrop/general_loot_hi,
/turf/open/floor/rogue/cobble,
/area/rogue/under/tomb/cave/wet)
"IE" = (
/turf/closed/wall/mineral/rogue/stone,
/area/rogue/under/tomb)
"IK" = (
/obj/effect/decal/remains/human,
/turf/open/floor/rogue/cobble,
/area/rogue/under/tomb/cave/wet)
"IP" = (
/obj/machinery/light/rogue/firebowl/standing/blue,
/turf/open/floor/rogue/cobblerock,
/area/rogue/under/tomb)
"Jm" = (
/turf/closed/mineral/rogue/bedrock,
/area/rogue/under/tomb)
"Kw" = (
/obj/structure/spider/stickyweb,
/obj/structure/spider/stickyweb,
/turf/open/floor/rogue/cobble/mossy,
/area/rogue/under/tomb)
"KG" = (
/mob/living/simple_animal/hostile/retaliate/rogue/spider,
/obj/effect/spawner/lootdrop/general_loot_low,
/turf/open/floor/rogue/cobble,
/area/rogue/under/tomb)
"KH" = (
/obj/structure/trap/curse/hidden,
/obj/effect/spawner/lootdrop/general_loot_low,
/turf/open/floor/rogue/cobble,
/area/rogue/under/tomb)
"KO" = (
/obj/structure/mineral_door/wood/deadbolt,
/turf/open/floor/rogue/cobble,
/area/rogue/under/tomb/indoors/church)
"Ld" = (
/mob/living/carbon/human/species/skeleton/npc/mediumspread,
/turf/open/floor/rogue/cobble/mossy,
/area/rogue/under/tomb)
"LN" = (
/mob/living/simple_animal/hostile/retaliate/rogue/spider,
/turf/open/floor/rogue/cobble,
/area/rogue/under/tomb)
"LQ" = (
/obj/structure/flora/roguegrass/water,
/turf/open/floor/rogue/dirt,
/area/rogue/under/tomb/wilds)
"Mq" = (
/obj/structure/stairs/stone{
	dir = 8
	},
/turf/open/floor/rogue/cobble,
/area/rogue/under/tomb)
"Ms" = (
/turf/open/floor/rogue/grass,
/area/rogue/under/tomb/wilds)
"MH" = (
/obj/effect/decal/remains/bigrat,
/turf/open/floor/rogue/cobble/mossy,
/area/rogue/under/tomb/cave/wet)
"NW" = (
/obj/effect/decal/remains/human,
/turf/open/water/swamp,
/area/rogue/under/tomb/cave/wet)
"Oa" = (
/obj/item/restraints/legcuffs/beartrap/armed/camouflage,
/turf/open/floor/rogue/cobblerock,
/area/rogue/under/tomb)
"Ol" = (
/turf/open/floor/rogue/blocks/stonered,
/area/rogue/under/tomb/indoors/church)
"Op" = (
/turf/closed/wall/mineral/rogue/stone/moss,
/area/rogue/under/tomb)
"OR" = (
/turf/open/floor/rogue/dirt/road,
/area/rogue/under/tomb/wilds)
"Pv" = (
/turf/closed/wall/mineral/rogue/stone,
/area/rogue/under/tomb/indoors/church)
"PR" = (
/obj/structure/fluff/statue/knight/r,
/turf/open/floor/rogue/blocks/stonered/tiny,
/area/rogue/under/tomb/indoors/church)
"Qw" = (
/obj/effect/decal/remains/human{
	pixel_y = 5
	},
/turf/open/floor/rogue/cobble/mossy,
/area/rogue/under/tomb)
"QJ" = (
/obj/item/restraints/legcuffs/beartrap/armed/camouflage,
/turf/open/floor/rogue/dirt,
/area/rogue/under/tomb/wilds)
"QL" = (
/obj/structure/bars/cemetery,
/turf/open/floor/rogue/grass,
/area/rogue/under/tomb/wilds)
"QO" = (
/obj/structure/fluff/walldeco/chains,
/obj/structure/closet/crate/chest/neu_fancy,
/obj/effect/spawner/lootdrop/roguetown/dungeon/armor,
/turf/open/floor/rogue/cobble,
/area/rogue/under/tomb)
"RU" = (
/obj/structure/fluff/railing/wood,
/obj/structure/fluff/railing/wood{
	dir = 4;
	pixel_x = 1
	},
/turf/open/floor/rogue/cobblerock,
/area/rogue/under/tomb)
"RY" = (
/mob/living/simple_animal/hostile/retaliate/rogue/minotaur/axe,
/turf/open/floor/rogue/cobble,
/area/rogue/under/tomb/cave/wet)
"St" = (
/obj/effect/decal/remains/cabbit,
/obj/structure/flora/roguegrass/water/reeds,
/turf/open/water/swamp,
/area/rogue/under/tomb/cave/wet)
"Su" = (
/obj/effect/spawner/lootdrop/general_loot_hi,
/turf/open/floor/rogue/cobble,
/area/rogue/under/tomb/cave/wet)
"Sy" = (
/mob/living/carbon/human/species/skeleton/npc/mediumspread,
/turf/open/floor/rogue/cobble,
/area/rogue/under/tomb)
"SE" = (
/obj/structure/fluff/statue/knight,
/turf/open/floor/rogue/blocks/stonered/tiny,
/area/rogue/under/tomb/indoors/church)
"To" = (
/obj/effect/spawner/roguemap/treeorstump,
/obj/structure/flora/roguegrass,
/turf/open/floor/rogue/grass,
/area/rogue/under/tomb/wilds)
"TC" = (
/obj/structure/fluff/railing/wood{
	dir = 4;
	pixel_x = 1
	},
/turf/open/floor/rogue/cobblerock,
/area/rogue/under/tomb)
"TJ" = (
/turf/open/floor/rogue/cobble/mossy,
/area/rogue/under/tomb)
"TT" = (
/obj/structure/closet/crate/chest/lootbox,
/obj/effect/spawner/lootdrop/general_loot_mid,
/turf/open/floor/rogue/cobble,
/area/rogue/under/tomb)
"Uk" = (
/obj/structure/trap/fire,
/turf/open/floor/rogue/blocks/stonered/tiny,
/area/rogue/under/tomb/indoors/church)
"Ul" = (
/obj/effect/decal/remains/human,
/obj/structure/bars,
/turf/open/floor/rogue/cobble,
/area/rogue/under/tomb/cave/wet)
"UX" = (
/obj/effect/spawner/lootdrop/potion_stats,
/turf/open/floor/rogue/cobble,
/area/rogue/under/tomb)
"WB" = (
/turf/closed/mineral/rogue/bedrock,
/area/rogue/under/tomb/wilds)
"WI" = (
/obj/machinery/light/rogue/firebowl/standing/blue,
/turf/open/floor/rogue/blocks,
/area/rogue/under/tomb)
"Xc" = (
/obj/item/ash{
	pixel_y = -6
	},
/obj/item/ash{
	pixel_y = 6
	},
/obj/item/ash{
	pixel_x = -10
	},
/turf/open/floor/rogue/cobble,
/area/rogue/under/tomb)
"Xw" = (
/obj/structure/spider/stickyweb,
/obj/structure/spider/stickyweb,
/turf/open/floor/rogue/cobble,
/area/rogue/under/tomb)
"XX" = (
/obj/structure/spider/stickyweb,
/turf/open/floor/rogue/cobble,
/area/rogue/under/tomb)
"YJ" = (
/mob/living/carbon/human/species/skeleton/npc/bogguard,
/turf/open/floor/rogue/cobble/mossy,
/area/rogue/under/tomb)
"YZ" = (
/obj/structure/flora/roguegrass,
/turf/open/floor/rogue/grass,
/area/rogue/under/tomb/wilds)
"Zk" = (
/obj/effect/decal/remains/human,
/obj/structure/flora/roguegrass/water/reeds,
/turf/open/water/swamp,
/area/rogue/under/tomb/cave/wet)
"Zl" = (
/obj/effect/decal/cleanable/blood/footprints,
/turf/open/floor/rogue/cobble/mossy,
/area/rogue/under/tomb)
"Zn" = (
/obj/structure/bars,
/obj/structure/bars,
/turf/open/floor/rogue/cobble,
/area/rogue/under/tomb/cave/wet)
"ZL" = (
/obj/effect/spawner/roguemap/treeorstump,
/obj/item/restraints/legcuffs/beartrap/armed/camouflage,
/turf/open/floor/rogue/grass,
/area/rogue/under/tomb/wilds)
"ZY" = (
/obj/structure/trap/curse/hidden,
/turf/open/floor/rogue/cobble/mossy,
/area/rogue/under/tomb)

(1,1,1) = {"
IE
IE
IE
IE
IE
IE
IE
IE
IE
IE
IE
IE
IE
IE
XX
yO
pq
IE
IE
IE
IE
IE
IE
IE
IE
IE
IE
IE
IE
IE
"}
(2,1,1) = {"
IE
XX
LN
gm
tm
gk
Zl
XX
gn
pq
pq
XX
pq
dQ
XX
tm
TJ
TJ
TJ
iC
pq
pq
XX
pq
sx
iC
IE
pq
pq
IE
"}
(3,1,1) = {"
IE
iC
TJ
XX
LN
pq
or
ZY
ip
xr
pq
LN
pq
dQ
pq
pq
sx
XX
tm
lX
tm
pq
pq
pq
TJ
pq
dQ
Sy
pq
IE
"}
(4,1,1) = {"
IE
wx
TT
IE
tu
tu
tu
IE
IE
IE
IE
pq
pq
IE
IE
IE
IE
IE
tu
tu
tu
IE
IE
IE
tm
pq
IE
pq
iC
IE
"}
(5,1,1) = {"
IE
IE
IE
IE
XX
pq
KG
XX
TJ
TJ
XX
pq
XX
tu
QO
qk
Sy
IE
pq
pq
pq
LN
pq
tu
TJ
LN
IE
XX
tt
IE
"}
(6,1,1) = {"
IE
XX
pq
IE
Qw
tm
tm
TJ
tm
TJ
tm
TJ
pq
tu
wN
pq
pq
dQ
yU
pq
XX
XX
XX
tu
pq
XX
IE
XX
Kw
IE
"}
(7,1,1) = {"
IE
XX
Sy
dQ
pq
LN
pZ
XX
Xw
XX
LN
XX
pq
tu
Sy
pq
pq
IE
XX
XX
pq
pq
yU
IE
TJ
XX
IE
tm
pq
IE
"}
(8,1,1) = {"
IE
pq
pq
IE
IE
IE
IE
IE
IE
IE
IE
IE
IE
IE
pq
sx
pq
IE
LN
pq
pq
XX
pq
dQ
TJ
pq
dQ
Ld
XX
IE
"}
(9,1,1) = {"
IE
pq
XX
nK
sx
Sy
pq
pq
pq
XX
pq
Ic
pq
dQ
pq
pq
qk
IE
tu
tu
IE
IE
IE
IE
aL
pq
IE
tm
tm
IE
"}
(10,1,1) = {"
IE
ci
XX
tu
XX
pq
pq
XX
Sy
pq
XX
pq
XX
IE
pq
pq
ci
IE
pB
pB
En
KH
ci
IE
ZY
TJ
IE
TT
TT
IE
"}
(11,1,1) = {"
IE
sx
pq
tu
pq
iC
pq
aB
En
En
En
En
aB
aB
En
En
En
Ul
Zk
pB
En
pq
XX
tu
pq
TJ
IE
IE
IE
IE
"}
(12,1,1) = {"
IE
XX
pq
tu
pq
XX
pq
En
pB
pB
pB
Zk
pB
pB
St
pB
pB
pB
pB
pB
En
pq
pq
IE
pq
XX
pq
XX
XX
IE
"}
(13,1,1) = {"
IE
pq
iC
nK
xp
XX
pq
En
pB
ug
NW
cD
fs
ug
ug
ft
cD
ug
ug
pB
En
XX
pq
tu
XX
pq
TJ
TJ
pq
IE
"}
(14,1,1) = {"
pq
XX
XX
tu
XX
XX
pq
En
pB
ug
cD
cD
yL
cD
cD
ft
sR
cD
ug
Zk
aB
XX
pq
IE
tu
IE
XX
pq
TJ
pq
"}
(15,1,1) = {"
BH
XX
pq
tu
TJ
pq
XX
En
Dp
ug
cD
cD
cD
RY
Su
IK
ft
cD
cD
pB
aB
ci
pq
pq
iC
IE
XX
zX
TJ
hQ
"}
(16,1,1) = {"
pq
pq
XX
tu
Ld
TJ
pq
aB
pB
ug
cD
cD
cD
cD
in
cD
cD
ft
ug
pB
En
pq
zX
IE
pq
dQ
pq
pq
TJ
TJ
"}
(17,1,1) = {"
IE
XX
pq
IE
iC
tm
XX
aB
pB
sZ
cD
fs
cD
Ir
cD
cD
cD
cD
NW
pB
En
pq
pq
IE
pq
IE
pq
XX
pq
IE
"}
(18,1,1) = {"
IE
IE
IE
IE
IE
pq
XX
Zn
pB
ug
cD
cD
cD
ft
cD
RY
cD
cD
NW
pB
En
Gi
TJ
pq
pq
IE
pq
pq
XX
IE
"}
(19,1,1) = {"
IE
ha
pq
LN
dQ
sx
pq
En
pB
ug
cD
cD
MH
ft
fs
cD
ft
sR
ug
pB
En
pq
pq
IE
Sy
IE
sx
pq
pq
IE
"}
(20,1,1) = {"
IE
pq
XX
LN
IE
pq
pq
En
pB
NW
ug
ft
ft
cD
cD
ft
ft
ft
cD
pB
En
pq
pq
IE
IE
IE
IE
IE
IE
IE
"}
(21,1,1) = {"
IE
XX
ZY
tm
IE
pq
ci
En
pB
ug
sZ
ug
ug
yL
cD
ft
ft
ug
ug
Dp
pM
pq
pq
Pv
Pv
ER
iB
ER
Pv
Pv
"}
(22,1,1) = {"
IE
XX
XX
TJ
IE
IE
IE
aB
pB
pB
pB
pB
Zk
pB
pB
pB
pB
pB
pB
pB
aB
pq
YJ
Pv
SE
ER
SE
Uk
SE
Pv
"}
(23,1,1) = {"
IE
XX
sx
Gi
IE
Mq
Mq
aB
aB
aB
En
En
En
En
aB
aB
En
En
En
En
aB
pq
TJ
Pv
ER
Uk
Ol
Ol
Uk
Pv
"}
(24,1,1) = {"
IE
pq
qE
TJ
IE
pq
pq
dQ
XX
XX
Gi
pq
Sy
pq
UX
XX
XX
pq
XX
XX
pq
pq
Xc
KO
ER
of
xg
Ol
bQ
Pv
"}
(25,1,1) = {"
IE
dQ
IE
IE
IE
pq
pq
IE
Sy
XX
XX
XX
pq
XX
XX
pq
Sy
pq
pq
XX
pq
TJ
mw
KO
ER
of
Ol
Ol
el
Pv
"}
(26,1,1) = {"
IE
pq
pq
pq
TJ
TJ
TJ
IE
IE
IE
tu
tu
tu
tu
IE
IE
tu
tu
tu
tu
IE
Ld
Gi
Pv
Uk
ER
Ol
Ol
Uk
Pv
"}
(27,1,1) = {"
IE
pq
pq
TJ
TJ
TJ
zX
IE
LN
pq
pq
pq
pq
pq
XX
pq
XX
XX
pq
XX
tu
hM
pq
Pv
PR
Uk
PR
Uk
PR
Pv
"}
(28,1,1) = {"
IE
dQ
IE
tu
tu
tu
IE
IE
pq
pq
zX
pq
XX
XX
TJ
TJ
TJ
tm
TJ
XX
tu
TJ
pq
Pv
Pv
ER
vk
ER
Pv
Pv
"}
(29,1,1) = {"
IE
pq
pq
Ld
TJ
iC
TJ
dQ
pq
Gi
pq
pq
XX
TJ
TJ
TJ
TJ
pq
XX
pq
IE
pq
TJ
Sy
IE
IE
IE
IE
IE
IE
"}
(30,1,1) = {"
IE
IE
IE
IE
IE
IE
IE
IE
IE
IE
IE
IE
IE
IE
TJ
Em
TJ
IE
IE
IE
IE
IE
IE
qe
IE
IE
IE
IE
IE
IE
"}

(1,1,2) = {"
WB
WB
WB
WB
WB
WB
WB
WB
WB
WB
WB
WB
WB
Ms
Ms
Ms
Ms
YZ
Ms
WB
WB
WB
WB
WB
WB
WB
WB
WB
WB
WB
"}
(2,1,2) = {"
WB
WB
WB
WB
WB
WB
WB
WB
WB
Ms
Ms
Ms
Ms
Ms
OR
OR
OR
YZ
YZ
Bb
YZ
YZ
YZ
WB
WB
WB
WB
WB
WB
WB
"}
(3,1,2) = {"
WB
WB
WB
WB
WB
Ms
Ms
Ms
YZ
To
Ms
Ay
Ms
Ms
CJ
LQ
OR
OR
Ms
Ms
Ay
Ms
Bb
Ms
WB
WB
WB
WB
WB
WB
"}
(4,1,2) = {"
WB
WB
WB
WB
Ms
Ms
Ay
Ms
YZ
Ms
Ms
YZ
Ms
OR
OR
LQ
tx
OR
OR
OR
Ms
Ms
Ms
Bb
EY
WB
WB
WB
WB
WB
"}
(5,1,2) = {"
WB
WB
WB
Ms
Ms
YZ
Ms
Ms
Bb
Ms
Ms
tx
OR
OR
tx
OR
OR
OR
OR
LQ
OR
OR
OR
Ms
YZ
Ms
WB
WB
WB
WB
"}
(6,1,2) = {"
WB
WB
WB
Bb
Ms
ZL
YZ
YZ
Ms
Ms
tx
OR
OR
OR
tx
OR
OR
OR
tx
OR
LQ
tx
OR
Bb
Ms
Ms
Ms
WB
WB
WB
"}
(7,1,2) = {"
WB
WB
WB
Ms
Bb
Ms
Ms
Ay
tx
tx
xd
tx
tx
Ms
Ms
Ms
Ms
bL
tx
tx
OR
tx
OR
OR
Ms
YZ
YZ
Ms
WB
WB
"}
(8,1,2) = {"
WB
WB
WB
Ms
YZ
Ms
Ms
tx
tx
OR
tx
Ms
Ms
YZ
YZ
YZ
Ms
Ms
Ms
tx
OR
OR
CJ
OR
OR
To
YZ
Ms
WB
WB
"}
(9,1,2) = {"
WB
WB
Ms
Ms
Ms
tx
tx
OR
OR
IE
qz
qz
IE
IE
HP
HP
Op
IE
qz
qz
IE
Ms
OR
OR
OR
YZ
To
vR
Ms
WB
"}
(10,1,2) = {"
WB
WB
Ms
Ms
tx
LQ
OR
OR
OR
IE
Co
Co
Co
Co
Co
Co
Co
DZ
zq
zq
IE
Ms
tx
OR
OR
Ms
YZ
YZ
Ms
WB
"}
(11,1,2) = {"
WB
WB
Bb
FD
tx
OR
OR
IE
qz
qz
DZ
DZ
DZ
DZ
DZ
DZ
DZ
DZ
zq
DZ
qz
Ms
LQ
OR
OR
Ms
Ms
bL
YZ
WB
"}
(12,1,2) = {"
WB
Ms
Ms
tx
QJ
OR
tx
Op
zq
zq
zq
zq
zq
zq
zq
zq
zq
zq
zq
zq
qz
Ms
tx
tx
tx
OR
Ms
Ay
Bb
WB
"}
(13,1,2) = {"
Ms
bL
Ms
tx
OR
OR
tx
qz
zq
zq
zq
zq
zq
zq
DZ
DZ
zq
zq
zq
DZ
IE
Ms
Ms
LQ
OR
OR
OR
OR
Ms
Ms
"}
(14,1,2) = {"
Ms
OR
tx
tx
OR
tx
tx
qz
zq
zq
zq
DZ
DZ
zq
DZ
DZ
zq
zq
zq
zq
Op
Ms
Bb
Ms
OR
OR
OR
tx
OR
OR
"}
(15,1,2) = {"
Ms
OR
LQ
OR
OR
OR
LQ
IE
IP
DZ
zq
DZ
DZ
zq
zq
zq
zq
zq
zq
bF
qz
Ms
YZ
Ms
tx
tx
OR
tx
OR
OR
"}
(16,1,2) = {"
Ms
OR
OR
OR
CJ
OR
tx
IE
DZ
DZ
zq
zq
zq
zq
zq
zq
zq
zq
zq
qi
qz
Ms
YZ
Ms
bL
tx
OR
OR
OR
OR
"}
(17,1,2) = {"
Ms
tx
LQ
Ms
tx
tx
Ms
qz
DZ
DZ
zq
zq
zq
zq
zq
zq
zq
zq
zq
IP
Op
Ms
Ms
YZ
Bb
tx
OR
tx
tx
Ms
"}
(18,1,2) = {"
qz
Op
Op
qz
qz
IE
IE
qz
zq
zq
zq
zq
zq
zq
DZ
Oa
zq
zq
zq
zq
IE
Ms
Ms
To
Ms
Ms
OR
CJ
tx
Ms
"}
(19,1,2) = {"
qz
WI
Co
Co
Co
Co
Co
DZ
DZ
DZ
zq
zq
zq
zq
DZ
DZ
zq
zq
zq
zq
qz
Bb
Ms
YZ
Ms
tx
OR
OR
Ms
WB
"}
(20,1,2) = {"
IE
Co
Co
Co
Co
Co
Co
IE
IE
DZ
zq
zq
zq
DZ
DZ
DZ
DZ
zq
zq
zq
qz
Ms
Ms
tx
tx
OR
OR
Ms
Ms
WB
"}
(21,1,2) = {"
IE
Co
Co
Co
DZ
DZ
DZ
IE
IE
DZ
DZ
DZ
DZ
DZ
WI
Co
DZ
zq
zq
zq
IE
LQ
tx
tx
OR
OR
Ms
Ms
Ms
WB
"}
(22,1,2) = {"
qz
Co
Co
Co
jS
my
my
Co
Co
Co
Co
Co
Cg
Co
Co
DZ
zq
zq
zq
zq
IE
tx
tx
tx
tx
Ms
tx
Ms
WB
WB
"}
(23,1,2) = {"
qz
WI
Co
Co
jS
zq
zq
qz
qz
Op
IE
qz
qz
IE
IE
qz
qz
IE
IE
qz
qz
OR
QJ
LQ
Ms
YZ
Ay
Ms
WB
WB
"}
(24,1,2) = {"
Jm
IE
Co
Co
jS
zq
zq
IE
jQ
Ms
lK
Ms
aX
Ms
Ms
Ms
tx
tx
Ms
OR
OR
OR
LQ
YZ
YZ
Ms
Ms
WB
WB
WB
"}
(25,1,2) = {"
Jm
IE
TC
TC
RU
zq
zq
IE
Ms
Ms
bL
YZ
QL
Ms
Bb
Ms
Ms
OR
OR
OR
OR
Ms
Ms
vR
bL
Bb
WB
WB
WB
WB
"}
(26,1,2) = {"
Jm
Jm
qz
zq
zq
zq
zq
qz
jQ
Ms
Ab
Ms
QL
Ms
BO
Fq
Ms
OR
tx
tx
tx
tx
YZ
Ms
Ms
WB
WB
WB
WB
WB
"}
(27,1,2) = {"
Jm
Jm
Jm
qz
IE
zq
zq
qz
Ms
Bb
YZ
Ms
QL
Ms
YZ
OR
OR
tx
LQ
tx
Ms
Ms
Ay
Ms
WB
WB
WB
WB
WB
WB
"}
(28,1,2) = {"
Jm
Jm
Jm
Jm
Jm
IE
IE
Op
lK
Ms
Ab
Ms
QL
Bb
Ms
OR
OR
tx
tx
Ms
Ms
YZ
Ms
WB
WB
WB
WB
WB
WB
WB
"}
(29,1,2) = {"
Jm
Jm
Jm
Jm
Jm
Jm
Jm
IE
Ms
Ms
Ms
Ms
QL
Ms
OR
tx
LQ
tx
Ms
vR
YZ
WB
WB
WB
WB
WB
WB
WB
WB
WB
"}
(30,1,2) = {"
Jm
Jm
Jm
Jm
Jm
Jm
Jm
Jm
WB
WB
WB
WB
WB
Ms
Ms
YZ
YZ
Ms
WB
WB
WB
WB
WB
WB
WB
WB
WB
WB
WB
WB
"}
