//MAP CONVERTED BY dmm2tgm.py THIS HEADER COMMENT PREVENTS RECONVERSION, DO NOT REMOVE
"cy" = (
/obj/effect/decal/cleanable/sigil/NE,
/turf/open/floor/rogue/ruinedwood/spiral,
/area/rogue/under/tomb/indoors)
"cA" = (
/obj/effect/decal/cleanable/sigil/SW,
/turf/open/floor/rogue/ruinedwood/spiral,
/area/rogue/under/tomb/indoors)
"dx" = (
/obj/machinery/light/rogue/candle/blue,
/obj/structure/table/vtable,
/obj/item/storage/belt/rogue/pouch,
/turf/open/floor/rogue/ruinedwood/spiral,
/area/rogue/under/tomb/indoors)
"eS" = (
/obj/effect/decal/cleanable/sigil/N,
/obj/machinery/light/rogue/candle/blue,
/turf/open/floor/rogue/ruinedwood/spiral,
/area/rogue/under/tomb/indoors)
"fo" = (
/obj/structure/bed/rogue/inn/double,
/obj/item/bedsheet/rogue/fabric_double,
/turf/open/floor/rogue/ruinedwood/spiral,
/area/rogue/under/tomb/indoors)
"fY" = (
/obj/structure/fluff/clock,
/turf/open/floor/rogue/ruinedwood/spiral,
/area/rogue/under/tomb/indoors)
"hc" = (
/obj/structure/mineral_door/wood/fancywood,
/obj/effect/mapping_helpers/access/locker,
/obj/item/soap/bath{
	pixel_y = -5
	},
/turf/open/floor/rogue/ruinedwood/spiral,
/area/rogue/under/tomb/indoors)
"hr" = (
/turf/closed/mineral/rogue/bedrock,
/area/rogue/under/tomb/cave/wet)
"ht" = (
/obj/structure/bed/rogue/shit,
/turf/open/floor/rogue/ruinedwood/spiral,
/area/rogue/under/tomb/indoors)
"hA" = (
/obj/machinery/light/rogue/candle/blue/r,
/turf/open/floor/rogue/ruinedwood/spiral,
/area/rogue/under/tomb/indoors)
"hL" = (
/mob/living/carbon/human/species/skeleton/npc/mediumspread,
/turf/open/floor/rogue/ruinedwood/spiral,
/area/rogue/under/tomb/indoors)
"hU" = (
/obj/structure/bed/rogue/shit,
/obj/item/roguestatue/iron,
/turf/open/floor/rogue/ruinedwood/spiral,
/area/rogue/under/tomb/indoors)
"il" = (
/obj/structure/stairs/d,
/turf/open/floor/rogue/ruinedwood/spiral,
/area/rogue/under/tomb/indoors)
"io" = (
/turf/open/transparent/openspace,
/area/rogue/under/tomb/indoors)
"iy" = (
/obj/structure/closet/crate/drawer/inn,
/obj/effect/spawner/lootdrop/valuable_clutter_spawner,
/turf/open/floor/rogue/ruinedwood/spiral,
/area/rogue/under/tomb/indoors)
"iO" = (
/obj/effect/decal/cleanable/sigil/W,
/mob/living/carbon/human/species/skeleton/npc/hardspread,
/turf/open/floor/rogue/ruinedwood/spiral,
/area/rogue/under/tomb/indoors)
"jl" = (
/mob/living/carbon/human/species/skeleton/npc/mediumspread,
/turf/open/water/bath,
/area/rogue/under/tomb/indoors)
"js" = (
/obj/structure/bed/rogue/shit,
/mob/living/carbon/human/species/skeleton/npc/mediumspread,
/turf/open/floor/rogue/ruinedwood/spiral,
/area/rogue/under/tomb/indoors)
"jL" = (
/obj/item/soap/bath{
	pixel_y = -5
	},
/turf/open/water/bath,
/area/rogue/under/tomb/indoors)
"jR" = (
/obj/structure/chair/wood/rogue,
/turf/open/floor/carpet/red,
/area/rogue/under/tomb/indoors)
"jV" = (
/turf/closed/wall/mineral/rogue/decowood,
/area/rogue/under/tomb/indoors)
"jX" = (
/obj/structure/mineral_door/wood/fancywood,
/obj/effect/mapping_helpers/access/locker,
/turf/open/floor/rogue/ruinedwood/spiral,
/area/rogue/under/tomb/indoors)
"kv" = (
/turf/open/water/bath,
/area/rogue/under/tomb/indoors)
"kQ" = (
/obj/machinery/light/rogue{
	pixel_y = 32
	},
/turf/open/floor/rogue/ruinedwood/spiral,
/area/rogue/under/tomb/indoors)
"mk" = (
/obj/structure/fluff/railing/border{
	dir = 10
	},
/turf/open/floor/rogue/ruinedwood/spiral,
/area/rogue/under/tomb/indoors)
"mv" = (
/obj/machinery/light/rogue/candle/blue,
/turf/open/water/bath,
/area/rogue/under/tomb/indoors)
"oo" = (
/mob/living/carbon/human/species/skeleton/npc/mediumspread,
/turf/open/floor/rogue/tile,
/area/rogue/under/tomb/indoors)
"oR" = (
/turf/open/water/swamp/deep,
/area/rogue/under/tomb/cave)
"oT" = (
/obj/structure/mineral_door/swing_door,
/turf/open/floor/rogue/tile,
/area/rogue/under/tomb/indoors)
"oW" = (
/turf/open/transparent/openspace,
/area/rogue/under/tomb/cave/wet)
"px" = (
/obj/structure/stairs,
/turf/open/floor/rogue/tile,
/area/rogue/under/tomb/indoors)
"pC" = (
/obj/structure/closet/crate/roguecloset,
/obj/item/clothing/suit/roguetown/shirt/dress/gen/black,
/obj/item/clothing/cloak/apron/waist,
/turf/open/floor/rogue/ruinedwood/spiral,
/area/rogue/under/tomb/indoors)
"pD" = (
/obj/structure/fluff/railing/border{
	dir = 4
	},
/turf/open/floor/rogue/ruinedwood/spiral,
/area/rogue/under/tomb/indoors)
"pZ" = (
/obj/structure/rack/rogue,
/obj/item/clothing/suit/roguetown/shirt/tunic/white,
/obj/item/clothing/suit/roguetown/shirt/tunic/white,
/obj/item/clothing/suit/roguetown/shirt/tunic/white,
/obj/effect/spawner/lootdrop/roguetown/dungeon/misc,
/turf/open/floor/rogue/ruinedwood/spiral,
/area/rogue/under/tomb/indoors)
"qU" = (
/obj/effect/decal/cleanable/sigil,
/obj/item/reagent_containers/powder/ozium{
	pixel_y = 2
	},
/obj/item/reagent_containers/powder/ozium{
	pixel_y = 15;
	pixel_x = -19
	},
/obj/item/reagent_containers/powder/ozium{
	pixel_y = 23
	},
/obj/item/reagent_containers/powder/ozium{
	pixel_y = 14;
	pixel_x = 21
	},
/obj/item/reagent_containers/powder/ozium{
	pixel_y = -12;
	pixel_x = -13
	},
/obj/item/reagent_containers/powder/ozium{
	pixel_y = -13;
	pixel_x = 14
	},
/turf/open/floor/rogue/ruinedwood/spiral,
/area/rogue/under/tomb/indoors)
"qZ" = (
/obj/structure/rack/rogue/shelf/big,
/obj/item/perfume/random{
	pixel_y = 24
	},
/obj/item/perfume/random{
	pixel_y = 24;
	pixel_x = 12
	},
/turf/open/floor/rogue/ruinedwood/spiral,
/area/rogue/under/tomb/indoors)
"rw" = (
/obj/structure/rack/rogue,
/obj/item/clothing/suit/roguetown/shirt/tunic/white,
/obj/effect/spawner/lootdrop/roguetown/dungeon/clothing,
/turf/open/floor/rogue/ruinedwood/spiral,
/area/rogue/under/tomb/indoors)
"rz" = (
/turf/open/floor/rogue/ruinedwood/spiral,
/area/rogue/under/tomb/indoors)
"rZ" = (
/obj/structure/table/wood{
	icon_state = "tablewood1"
	},
/obj/effect/spawner/lootdrop/general_loot_mid,
/turf/open/floor/rogue/ruinedwood/spiral,
/area/rogue/under/tomb/indoors)
"tg" = (
/obj/effect/decal/cleanable/sigil/SE,
/turf/open/floor/rogue/ruinedwood/spiral,
/area/rogue/under/tomb/indoors)
"tC" = (
/obj/structure/closet/crate/roguecloset,
/obj/item/clothing/suit/roguetown/shirt/dress/gen/black,
/obj/item/clothing/cloak/apron/waist,
/obj/effect/spawner/lootdrop/roguetown/dungeon/money,
/turf/open/floor/rogue/ruinedwood/spiral,
/area/rogue/under/tomb/indoors)
"uc" = (
/obj/structure/table/wood{
	icon_state = "tablewood1"
	},
/obj/effect/spawner/lootdrop/general_loot_low,
/turf/open/floor/rogue/ruinedwood/spiral,
/area/rogue/under/tomb/indoors)
"ug" = (
/turf/open/floor/rogue/naturalstone,
/area/rogue/under/tomb/cave/wet)
"uv" = (
/obj/structure/table/vtable,
/obj/item/rogueweapon/huntingknife/idagger/silver/arcyne,
/turf/open/floor/rogue/ruinedwood/spiral,
/area/rogue/under/tomb/indoors)
"uF" = (
/obj/structure/chair/stool/rogue,
/turf/open/floor/rogue/ruinedwood/spiral,
/area/rogue/under/tomb/indoors)
"xm" = (
/obj/structure/rack/rogue/shelf/big,
/obj/item/perfume/random{
	pixel_y = 25
	},
/obj/item/perfume/random{
	pixel_y = 27;
	pixel_x = 13
	},
/turf/open/floor/rogue/ruinedwood/spiral,
/area/rogue/under/tomb/indoors)
"yB" = (
/obj/machinery/light/rogue/candle/blue/l,
/turf/open/floor/rogue/ruinedwood/spiral,
/area/rogue/under/tomb/indoors)
"yX" = (
/obj/effect/dungeon_directional_helper/west,
/turf/open/floor/rogue/dirt,
/area/rogue/under/tomb/cave/wet)
"zC" = (
/obj/structure/fluff/railing/border{
	dir = 8
	},
/turf/open/floor/rogue/ruinedwood/spiral,
/area/rogue/under/tomb/indoors)
"AD" = (
/obj/machinery/light/rogue/candle/blue,
/obj/structure/bed/rogue/shit,
/turf/open/floor/rogue/ruinedwood/spiral,
/area/rogue/under/tomb/indoors)
"Be" = (
/turf/open/water/swamp/deep,
/area/rogue/under/tomb/cave/wet)
"Cj" = (
/obj/effect/spawner/lootdrop/valuable_clutter_spawner,
/turf/open/floor/rogue/tile,
/area/rogue/under/tomb/indoors)
"Cw" = (
/obj/structure/table/wood{
	icon_state = "tablewood1"
	},
/obj/item/reagent_containers/glass/bottle/rogue/beer/hagwoodbitter,
/obj/effect/spawner/lootdrop/general_loot_low,
/turf/open/floor/rogue/ruinedwood/spiral,
/area/rogue/under/tomb/indoors)
"Cy" = (
/obj/effect/dungeon_directional_helper/north,
/turf/open/floor/rogue/dirt,
/area/rogue/under/tomb/cave/wet)
"CB" = (
/mob/living/carbon/human/species/skeleton/npc/bogguard,
/turf/open/floor/rogue/ruinedwood/spiral,
/area/rogue/under/tomb/indoors)
"Dh" = (
/turf/open/floor/rogue/rooftop{
	dir = 1
	},
/area/rogue/under/tomb/cave/wet)
"Ff" = (
/obj/item/soap{
	pixel_x = -3;
	pixel_y = -5
	},
/obj/structure/mineral_door/swing_door,
/turf/open/floor/rogue/ruinedwood/spiral,
/area/rogue/under/tomb/indoors)
"Fy" = (
/mob/living/carbon/human/species/skeleton/npc/mediumspread,
/turf/open/water/swamp/deep,
/area/rogue/under/tomb/cave)
"FC" = (
/turf/open/floor/rogue/dirt,
/area/rogue/under/tomb/cave/wet)
"Gb" = (
/obj/item/soap/bath{
	pixel_y = -5
	},
/mob/living/carbon/human/species/skeleton/npc/mediumspread,
/turf/open/water/bath,
/area/rogue/under/tomb/indoors)
"Gm" = (
/turf/open/floor/rogue/tile,
/area/rogue/under/tomb/indoors)
"Ha" = (
/turf/open/floor/rogue/rooftop{
	dir = 4
	},
/area/rogue/under/tomb/cave/wet)
"If" = (
/obj/item/soap/bath{
	pixel_y = -5
	},
/obj/structure/mineral_door/swing_door,
/turf/open/floor/rogue/tile,
/area/rogue/under/tomb/indoors)
"Ii" = (
/obj/structure/roguewindow/openclose/reinforced{
	dir = 1
	},
/turf/open/floor/rogue/ruinedwood/spiral,
/area/rogue/under/tomb/indoors)
"Iq" = (
/turf/open/floor/rogue/rooftop,
/area/rogue/under/tomb/cave/wet)
"IM" = (
/obj/effect/decal/cleanable/sigil/E,
/turf/open/floor/rogue/ruinedwood/spiral,
/area/rogue/under/tomb/indoors)
"JE" = (
/turf/closed/wall/mineral/rogue/decowood/vert,
/area/rogue/under/tomb/indoors)
"JF" = (
/obj/structure/fluff/railing/border{
	dir = 9
	},
/turf/open/floor/rogue/ruinedwood/spiral,
/area/rogue/under/tomb/indoors)
"JH" = (
/obj/structure/rack/rogue/shelf/big,
/obj/item/perfume/random{
	pixel_y = 24
	},
/obj/item/perfume/random{
	pixel_x = 12;
	pixel_y = 27
	},
/turf/open/floor/rogue/ruinedwood/spiral,
/area/rogue/under/tomb/indoors)
"JN" = (
/obj/effect/spawner/lootdrop/random_gem,
/turf/open/water/bath,
/area/rogue/under/tomb/indoors)
"Kf" = (
/obj/machinery/light/rogue/candle/blue,
/obj/structure/closet/crate/drawer/inn,
/turf/open/floor/rogue/ruinedwood/spiral,
/area/rogue/under/tomb/indoors)
"Kp" = (
/obj/structure/fluff/railing/border,
/turf/open/floor/rogue/ruinedwood/spiral,
/area/rogue/under/tomb/indoors)
"LO" = (
/obj/effect/decal/cleanable/sigil/S,
/turf/open/floor/rogue/ruinedwood/spiral,
/area/rogue/under/tomb/indoors)
"LY" = (
/obj/structure/table/wood{
	icon_state = "tablewood1"
	},
/obj/item/reagent_containers/glass/cup/wooden{
	pixel_x = -8;
	pixel_y = 4
	},
/turf/open/floor/rogue/ruinedwood/spiral,
/area/rogue/under/tomb/indoors)
"Nh" = (
/obj/machinery/light/rogue/candle/blue,
/obj/structure/closet/crate/drawer/inn,
/obj/effect/spawner/lootdrop/random_gem,
/turf/open/floor/rogue/ruinedwood/spiral,
/area/rogue/under/tomb/indoors)
"On" = (
/turf/open/floor/carpet/red,
/area/rogue/under/tomb/indoors)
"Pk" = (
/obj/item/clothing/ring/quartz,
/obj/effect/mapping_helpers/floor_clothing_equipper,
/mob/living/carbon/human/species/skeleton/npc/no_equipment,
/obj/item/clothing/suit/roguetown/shirt/tunic/black,
/obj/item/rogueweapon/huntingknife/idagger/steel/parrying,
/turf/open/floor/rogue/ruinedwood/spiral,
/area/rogue/under/tomb/indoors)
"Px" = (
/mob/living/carbon/human/species/skeleton/npc/dungeon,
/turf/open/floor/rogue/ruinedwood/spiral,
/area/rogue/under/tomb/indoors)
"Rj" = (
/obj/structure/roguewindow/openclose/reinforced,
/turf/open/floor/rogue/ruinedwood/spiral,
/area/rogue/under/tomb/indoors)
"Rk" = (
/obj/structure/fluff/railing/border{
	dir = 5
	},
/turf/open/floor/rogue/ruinedwood/spiral,
/area/rogue/under/tomb/indoors)
"RE" = (
/obj/structure/table/vtable/v2,
/obj/item/rogueweapon/huntingknife/idagger/silver{
	pixel_y = 3;
	pixel_x = -3
	},
/obj/item/reagent_containers/powder/moondust,
/obj/item/reagent_containers/powder/moondust{
	pixel_y = 10;
	pixel_x = -13
	},
/obj/item/reagent_containers/powder/moondust{
	pixel_y = 10;
	pixel_x = 10
	},
/turf/open/floor/rogue/ruinedwood/spiral,
/area/rogue/under/tomb/indoors)
"RU" = (
/obj/effect/decal/cleanable/sigil/NW,
/turf/open/floor/rogue/ruinedwood/spiral,
/area/rogue/under/tomb/indoors)
"SC" = (
/obj/item/storage/belt/rogue/pouch,
/obj/structure/table/vtable/v2,
/turf/open/floor/rogue/ruinedwood/spiral,
/area/rogue/under/tomb/indoors)
"TO" = (
/obj/effect/dungeon_directional_helper/south,
/turf/open/floor/rogue/dirt,
/area/rogue/under/tomb/cave/wet)
"WI" = (
/turf/open/floor/rogue/rooftop{
	dir = 8
	},
/area/rogue/under/tomb/cave/wet)
"WN" = (
/obj/effect/dungeon_directional_helper/east,
/turf/open/floor/rogue/dirt,
/area/rogue/under/tomb/cave/wet)
"Yt" = (
/mob/living/carbon/human/species/skeleton/npc/mediumspread,
/turf/open/water/swamp/deep,
/area/rogue/under/tomb/cave/wet)
"Zk" = (
/obj/machinery/light/rogue/candle/blue,
/obj/structure/rack/rogue/shelf/big,
/obj/item/perfume/random{
	pixel_y = 25
	},
/obj/item/perfume/random{
	pixel_y = 23;
	pixel_x = 14
	},
/turf/open/floor/rogue/ruinedwood/spiral,
/area/rogue/under/tomb/indoors)
"Zx" = (
/obj/structure/table/wood{
	icon_state = "tablewood1"
	},
/obj/item/reagent_containers/glass/cup/wooden{
	pixel_x = -8;
	pixel_y = 4
	},
/obj/effect/spawner/lootdrop/roguetown/dungeon/food,
/turf/open/floor/rogue/ruinedwood/spiral,
/area/rogue/under/tomb/indoors)
"ZC" = (
/obj/structure/fluff/railing/border{
	dir = 6
	},
/turf/open/floor/rogue/ruinedwood/spiral,
/area/rogue/under/tomb/indoors)
"ZQ" = (
/obj/machinery/light/rogue/candle/blue,
/turf/open/floor/rogue/tile,
/area/rogue/under/tomb/indoors)

(1,1,1) = {"
hr
hr
hr
hr
hr
hr
hr
hr
hr
yX
FC
hr
hr
hr
hr
hr
hr
hr
hr
hr
"}
(2,1,1) = {"
hr
FC
FC
FC
FC
FC
FC
FC
FC
FC
FC
FC
FC
FC
FC
FC
FC
FC
FC
hr
"}
(3,1,1) = {"
hr
FC
Be
Be
Be
Be
Be
Be
Be
Be
Be
Be
Be
Be
Be
Be
Be
Be
FC
hr
"}
(4,1,1) = {"
hr
FC
Be
JE
JE
JE
JE
JE
JE
Be
Be
JE
JE
JE
JE
JE
JE
Be
FC
hr
"}
(5,1,1) = {"
hr
FC
Be
JE
kv
kv
jL
Gm
oT
Be
Be
oT
Gm
jL
kv
kv
JE
Be
FC
hr
"}
(6,1,1) = {"
hr
FC
Be
JE
Gb
kv
kv
Gm
JE
Be
Be
JE
ZQ
kv
kv
kv
JE
Be
FC
hr
"}
(7,1,1) = {"
hr
FC
Be
JE
mv
kv
kv
Cj
JE
Be
Be
JE
Gm
kv
Gb
kv
JE
Be
FC
hr
"}
(8,1,1) = {"
hr
FC
Be
JE
Gm
Gm
Gm
Gm
JE
Be
Be
JE
Gm
Gm
Gm
Gm
JE
Be
FC
hr
"}
(9,1,1) = {"
hr
FC
Be
JE
If
JE
JE
JE
Gm
oo
Gm
Gm
JE
JE
JE
If
JE
Be
FC
hr
"}
(10,1,1) = {"
FC
FC
Be
Be
Be
Be
Yt
Be
Gm
px
JE
Gm
oR
oR
oR
oR
oR
Be
FC
FC
"}
(11,1,1) = {"
Cy
FC
Be
Be
Be
Be
Be
Be
Gm
px
JE
Gm
oR
Fy
oR
oR
oR
Be
FC
TO
"}
(12,1,1) = {"
hr
FC
Be
JE
oT
JE
JE
JE
Gm
Gm
Gm
Gm
JE
JE
JE
oT
JE
Be
FC
hr
"}
(13,1,1) = {"
hr
FC
Be
JE
Gm
Gm
Gm
Gm
JE
Be
Be
JE
Gm
Gm
Gm
Gm
JE
Be
FC
hr
"}
(14,1,1) = {"
hr
FC
Be
JE
mv
kv
jL
Gm
JE
Be
Be
JE
ZQ
kv
kv
jL
JE
Be
FC
hr
"}
(15,1,1) = {"
hr
FC
Be
JE
kv
kv
jl
Gm
JE
Be
Be
JE
Gm
jL
kv
jl
JE
Be
FC
hr
"}
(16,1,1) = {"
hr
FC
Be
JE
kv
kv
kv
Gm
If
Be
Be
If
Gm
kv
jl
JN
JE
Be
FC
hr
"}
(17,1,1) = {"
hr
FC
Be
JE
JE
JE
JE
JE
JE
Be
Be
JE
JE
JE
JE
JE
JE
Be
FC
hr
"}
(18,1,1) = {"
hr
FC
Be
Be
Be
Be
Be
Be
Be
Be
Be
Be
Be
Be
Be
Be
Be
Be
FC
hr
"}
(19,1,1) = {"
hr
FC
FC
FC
FC
FC
FC
FC
FC
FC
FC
FC
FC
FC
FC
FC
FC
FC
FC
hr
"}
(20,1,1) = {"
hr
hr
hr
hr
hr
hr
hr
hr
hr
WN
FC
hr
hr
hr
hr
hr
hr
hr
hr
hr
"}

(1,1,2) = {"
hr
hr
hr
hr
hr
hr
hr
hr
ug
ug
ug
ug
hr
hr
hr
hr
hr
hr
hr
hr
"}
(2,1,2) = {"
hr
oW
oW
oW
oW
oW
oW
oW
oW
oW
oW
oW
oW
oW
oW
oW
oW
oW
oW
hr
"}
(3,1,2) = {"
hr
oW
oW
WI
WI
WI
WI
WI
WI
WI
WI
WI
WI
WI
WI
WI
WI
oW
oW
hr
"}
(4,1,2) = {"
hr
oW
Dh
jV
jV
jV
jV
jV
jV
jV
jV
jV
jV
jV
jV
jV
jV
Iq
oW
hr
"}
(5,1,2) = {"
hr
oW
Dh
jV
js
rz
hU
jV
RU
iO
cA
uv
jV
xm
Pk
pZ
jV
Iq
oW
hr
"}
(6,1,2) = {"
hr
oW
Dh
jV
AD
hL
ht
jV
eS
qU
LO
SC
jV
Zk
rz
rz
jV
Iq
oW
hr
"}
(7,1,2) = {"
hr
oW
Dh
jV
hU
rz
ht
jV
cy
IM
tg
fY
jV
qZ
rz
rz
jV
Iq
oW
hr
"}
(8,1,2) = {"
hr
oW
Dh
jV
tC
rz
hL
jV
rz
rz
rz
rz
jV
JH
rz
rw
jV
Iq
oW
hr
"}
(9,1,2) = {"
ug
oW
Dh
jV
jV
Ff
jV
jV
ZC
pD
pD
Rk
jV
jV
hc
jV
jV
Iq
oW
ug
"}
(10,1,2) = {"
ug
oW
Dh
Rj
LY
rz
rz
rz
Kp
io
il
rz
hL
yB
rz
rz
Ii
Iq
oW
ug
"}
(11,1,2) = {"
ug
oW
Dh
Rj
uc
rz
rz
rz
Kp
io
il
rz
rz
hA
rz
uc
Ii
Iq
oW
ug
"}
(12,1,2) = {"
ug
oW
Dh
jV
jV
jX
jV
jV
mk
zC
zC
JF
jV
jV
jX
jV
jV
Iq
oW
ug
"}
(13,1,2) = {"
hr
oW
Dh
jV
Px
rz
pC
jV
rz
rz
rz
uF
jV
hL
rz
rZ
jV
Iq
oW
hr
"}
(14,1,2) = {"
hr
oW
Dh
jV
kQ
rz
rz
jV
dx
On
jR
Cw
jV
iy
rz
uF
jV
Iq
oW
hr
"}
(15,1,2) = {"
hr
oW
Dh
jV
Nh
rz
rz
jV
RE
On
jR
Zx
jV
Kf
rz
hL
jV
Iq
oW
hr
"}
(16,1,2) = {"
hr
oW
Dh
jV
fo
rz
CB
jV
Px
rz
rz
uF
jV
fo
rz
pC
jV
Iq
oW
hr
"}
(17,1,2) = {"
hr
oW
Dh
jV
jV
jV
jV
jV
jV
jV
jV
jV
jV
jV
jV
jV
jV
Iq
oW
hr
"}
(18,1,2) = {"
hr
oW
oW
Ha
Ha
Ha
Ha
Ha
Ha
Ha
Ha
Ha
Ha
Ha
Ha
Ha
Ha
oW
oW
hr
"}
(19,1,2) = {"
hr
oW
oW
oW
oW
oW
oW
oW
oW
oW
oW
oW
oW
oW
oW
oW
oW
oW
oW
hr
"}
(20,1,2) = {"
hr
hr
hr
hr
hr
hr
hr
hr
ug
ug
ug
ug
hr
hr
hr
hr
hr
hr
hr
hr
"}
