//MAP CONVERTED BY dmm2tgm.py THIS HEADER COMMENT PREVENTS RECONVERSION, DO NOT REMOVE
"a" = (
/turf/open/lava,
/area/rogue/under/tomb/cave/lava)
"b" = (
/turf/closed/mineral/rogue/bedrock,
/area/rogue/under/tomb/wilds)
"c" = (
/obj/item/fishingrod,
/turf/open/floor/rogue/dirt,
/area/rogue/under/tomb/wilds)
"h" = (
/obj/effect/spawner/roguemap/treeorbush,
/obj/effect/spawner/roguemap/treeorbush,
/turf/open/floor/rogue/dirt,
/area/rogue/under/tomb/wilds)
"i" = (
/obj/effect/dungeon_directional_helper/west,
/turf/open/floor/rogue/naturalstone,
/area/rogue/under/tomb/cave/lava)
"m" = (
/obj/structure/flora/ausbushes/brflowers,
/turf/open/floor/rogue/dirt,
/area/rogue/under/tomb/wilds)
"n" = (
/obj/effect/dungeon_directional_helper/east,
/turf/open/floor/rogue/naturalstone,
/area/rogue/under/tomb/cave/lava)
"s" = (
/obj/item/natural/rock/gem,
/turf/open/floor/rogue/naturalstone,
/area/rogue/under/tomb/cave/lava)
"u" = (
/obj/effect/spawner/roguemap/treeorstump,
/turf/open/floor/rogue/dirt,
/area/rogue/under/tomb/wilds)
"v" = (
/obj/item/natural/rock,
/turf/open/floor/rogue/naturalstone,
/area/rogue/under/tomb/cave/lava)
"B" = (
/obj/item/natural/worms,
/obj/item/natural/worms{
	pixel_y = 4;
	pixel_x = -8
	},
/obj/item/natural/worms{
	pixel_y = -4;
	pixel_x = -10
	},
/obj/item/natural/worms{
	pixel_y = 5;
	pixel_x = 9
	},
/obj/item/natural/worms{
	pixel_y = -9;
	dir = 4
	},
/turf/open/floor/rogue/dirt,
/area/rogue/under/tomb/wilds)
"C" = (
/obj/structure/flora/roguegrass/bush/wall,
/turf/open/floor/rogue/dirt,
/area/rogue/under/tomb/wilds)
"D" = (
/turf/closed/mineral/rogue/bedrock,
/area/rogue/under/tomb/cave/lava)
"H" = (
/turf/open/floor/rogue/dirt,
/area/rogue/under/tomb/wilds)
"I" = (
/obj/effect/spawner/roguemap/treeorbush,
/turf/open/floor/rogue/dirt,
/area/rogue/under/tomb/wilds)
"K" = (
/mob/living/simple_animal/hostile/retaliate/rogue/mole,
/turf/open/floor/rogue/naturalstone,
/area/rogue/under/tomb/cave/lava)
"L" = (
/turf/open/water/cleanshallow,
/area/rogue/under/tomb/wilds)
"N" = (
/obj/structure/roguerock,
/turf/open/floor/rogue/naturalstone,
/area/rogue/under/tomb/cave/lava)
"P" = (
/obj/effect/dungeon_directional_helper/south,
/turf/open/floor/rogue/naturalstone,
/area/rogue/under/tomb/cave/lava)
"Q" = (
/obj/structure/flora/rock,
/turf/open/floor/rogue/naturalstone,
/area/rogue/under/tomb/cave/lava)
"T" = (
/turf/open/floor/rogue/naturalstone,
/area/rogue/under/tomb/cave/lava)
"V" = (
/obj/effect/dungeon_directional_helper/north,
/turf/open/floor/rogue/naturalstone,
/area/rogue/under/tomb/cave/lava)
"X" = (
/obj/structure/flora/rock/pile,
/obj/effect/spawner/lootdrop/random_gem,
/turf/open/floor/rogue/naturalstone,
/area/rogue/under/tomb/cave/lava)
"Y" = (
/mob/living/simple_animal/hostile/retaliate/rogue/saiga/saigabuck,
/turf/open/floor/rogue/dirt,
/area/rogue/under/tomb/wilds)

(1,1,1) = {"
D
D
D
D
D
D
T
i
T
D
D
D
D
D
D
"}
(2,1,1) = {"
D
T
a
T
T
T
T
a
a
T
T
a
T
T
D
"}
(3,1,1) = {"
D
T
a
T
v
T
a
T
T
Q
T
a
a
T
D
"}
(4,1,1) = {"
D
T
a
a
T
a
a
a
T
a
a
a
a
T
D
"}
(5,1,1) = {"
D
T
T
a
a
a
a
a
a
a
a
T
a
T
D
"}
(6,1,1) = {"
D
T
T
T
a
s
T
T
T
T
T
a
a
T
D
"}
(7,1,1) = {"
T
T
T
a
a
T
T
K
T
a
T
a
a
T
T
"}
(8,1,1) = {"
V
T
T
a
a
T
T
T
X
T
K
T
a
T
P
"}
(9,1,1) = {"
T
T
T
T
a
T
T
K
T
T
T
T
a
T
T
"}
(10,1,1) = {"
D
T
T
T
a
a
T
a
T
T
T
T
a
T
D
"}
(11,1,1) = {"
D
T
T
a
a
a
a
a
a
a
T
N
a
T
D
"}
(12,1,1) = {"
D
T
T
T
a
T
T
v
T
a
a
a
a
a
D
"}
(13,1,1) = {"
D
T
v
T
a
a
T
a
T
a
a
a
T
T
D
"}
(14,1,1) = {"
D
T
T
T
T
a
T
T
T
a
a
T
N
T
D
"}
(15,1,1) = {"
D
D
D
D
D
D
T
n
T
D
D
D
D
D
D
"}

(1,1,2) = {"
b
b
b
b
b
b
H
H
H
b
b
b
b
b
b
"}
(2,1,2) = {"
b
H
H
H
H
H
H
m
H
H
H
H
L
L
b
"}
(3,1,2) = {"
b
H
I
I
H
C
C
C
C
H
u
L
L
I
b
"}
(4,1,2) = {"
b
H
I
H
H
H
H
I
I
H
L
L
I
I
b
"}
(5,1,2) = {"
b
H
h
H
L
L
L
H
H
L
L
H
I
H
b
"}
(6,1,2) = {"
b
H
I
H
L
u
L
L
L
L
L
L
H
I
b
"}
(7,1,2) = {"
H
H
I
H
L
Y
H
L
L
L
L
L
H
I
H
"}
(8,1,2) = {"
H
H
I
H
L
H
u
L
L
c
B
L
H
I
H
"}
(9,1,2) = {"
H
I
I
L
L
H
L
L
u
H
m
L
I
I
H
"}
(10,1,2) = {"
b
I
H
L
H
H
L
L
L
L
L
L
H
H
b
"}
(11,1,2) = {"
b
H
H
L
I
H
H
H
H
L
L
L
H
H
b
"}
(12,1,2) = {"
b
H
H
L
H
I
I
H
I
H
H
H
H
H
b
"}
(13,1,2) = {"
b
L
L
L
H
I
I
H
I
h
I
I
I
I
b
"}
(14,1,2) = {"
b
L
H
H
H
H
H
H
H
H
H
H
H
H
b
"}
(15,1,2) = {"
b
b
b
b
b
b
H
H
H
b
b
b
b
b
b
"}
