//MAP CONVERTED BY dmm2tgm.py THIS HEADER COMMENT PREVENTS RECONVERSION, DO NOT REMOVE
"ah" = (
/mob/living/simple_animal/hostile/retaliate/rogue/wolf,
/obj/effect/decal/cleanable/blood/old,
/turf/open/floor/rogue/metal,
/area/rogue/under/tomb)
"bc" = (
/turf/open/floor/rogue/metal,
/area/rogue/under/tomb)
"dm" = (
/obj/effect/decal/cleanable/dirt,
/obj/structure/rack/rogue/shelf{
	pixel_y = -32
	},
/turf/open/floor/rogue/ruinedwood/chevron,
/area/rogue/under/tomb)
"dA" = (
/obj/machinery/light/rogue/torchholder/r,
/turf/open/floor/rogue/dirt,
/area/rogue/under/tomb)
"ep" = (
/obj/machinery/light/rogue/torchholder/l,
/turf/open/floor/rogue/ruinedwood/chevron,
/area/rogue/under/tomb)
"ey" = (
/obj/effect/decal/cleanable/dirt,
/obj/structure/chair/wood/rogue,
/turf/open/floor/rogue/ruinedwood/chevron,
/area/rogue/under/tomb)
"fd" = (
/mob/living/simple_animal/hostile/retaliate/rogue/wolf,
/turf/open/floor/rogue/metal,
/area/rogue/under/tomb)
"gj" = (
/obj/machinery/light/rogue/torchholder{
	dir = 1
	},
/turf/open/floor/rogue/ruinedwood/chevron,
/area/rogue/under/tomb)
"hG" = (
/obj/structure/chair/wood/rogue,
/turf/open/floor/rogue/ruinedwood/chevron,
/area/rogue/under/tomb)
"ic" = (
/obj/effect/decal/cleanable/dirt,
/obj/item/chair/rogue,
/turf/open/floor/rogue/ruinedwood/chevron,
/area/rogue/under/tomb)
"in" = (
/obj/effect/decal/cleanable/blood/old,
/turf/open/floor/rogue/ruinedwood,
/area/rogue/under/tomb)
"iz" = (
/obj/effect/decal/cleanable/blood/tracks{
	dir = 10
	},
/turf/open/floor/rogue/metal,
/area/rogue/under/tomb)
"kp" = (
/obj/effect/dungeon_directional_helper/east,
/turf/open/floor/rogue/dirt,
/area/rogue/under/tomb)
"ks" = (
/obj/structure/closet/crate/chest/gold,
/obj/item/clothing/head/roguetown/helmet/sallet/visored,
/obj/item/clothing/gloves/roguetown/plate,
/turf/open/floor/rogue/metal,
/area/rogue/under/tomb)
"lh" = (
/obj/effect/decal/cleanable/vomit/old,
/obj/machinery/light/rogue/torchholder/r,
/turf/open/floor/rogue/ruinedwood/chevron,
/area/rogue/under/tomb)
"lE" = (
/turf/open/lava/acid,
/area/rogue/under/tomb)
"mB" = (
/obj/effect/decal/cleanable/blood/old,
/turf/open/floor/rogue/ruinedwood/chevron,
/area/rogue/under/tomb)
"nH" = (
/obj/structure/chair/wood/rogue{
	dir = 8
	},
/turf/open/floor/rogue/ruinedwood/chevron,
/area/rogue/under/tomb)
"qW" = (
/obj/structure/mineral_door/wood/window{
	dir = 8
	},
/turf/open/floor/rogue/metal,
/area/rogue/under/tomb)
"ry" = (
/obj/structure/closet/crate/chest/gold,
/obj/item/rogueweapon/sword/cutlass,
/obj/item/rogueweapon/huntingknife/idagger/silver,
/obj/item/rogueweapon/shield/tower/metal,
/turf/open/floor/rogue/metal,
/area/rogue/under/tomb)
"rz" = (
/turf/open/floor/rogue/dirt,
/area/rogue/under/tomb)
"sz" = (
/obj/machinery/light/rogue/firebowl/standing,
/turf/open/transparent/openspace,
/area/rogue/under/tomb)
"sC" = (
/obj/structure/chair/wood/rogue{
	dir = 1
	},
/turf/open/floor/rogue/ruinedwood/chevron,
/area/rogue/under/tomb)
"uf" = (
/obj/effect/decal/cleanable/vomit/old,
/obj/structure/chair/wood/rogue,
/turf/open/floor/rogue/ruinedwood/chevron,
/area/rogue/under/tomb)
"vC" = (
/obj/structure/fluff/railing/wood,
/turf/open/floor/rogue/ruinedwood/chevron,
/area/rogue/under/tomb)
"wg" = (
/turf/closed/wall/mineral/rogue/wooddark,
/area/rogue/under/tomb)
"wj" = (
/mob/living/simple_animal/hostile/retaliate/rogue/wolf,
/obj/effect/decal/cleanable/blood/tracks{
	dir = 4
	},
/turf/open/floor/rogue/metal,
/area/rogue/under/tomb)
"AZ" = (
/obj/effect/dungeon_directional_helper/west,
/turf/open/floor/rogue/dirt,
/area/rogue/under/tomb)
"Be" = (
/obj/structure/fluff/railing/wood{
	dir = 1
	},
/turf/open/floor/rogue/ruinedwood/chevron,
/area/rogue/under/tomb)
"Bw" = (
/obj/item/reagent_containers/glass/bottle/rogue/redwine,
/turf/closed/mineral/rogue/bedrock,
/area/rogue/under/tomb)
"BJ" = (
/obj/machinery/light/rogue/torchholder{
	dir = 1
	},
/turf/open/floor/rogue/dirt,
/area/rogue/under/tomb)
"CF" = (
/obj/structure/mineral_door/wood/window{
	dir = 4
	},
/turf/open/floor/rogue/metal,
/area/rogue/under/tomb)
"Ez" = (
/obj/machinery/light/rogue/torchholder/l,
/turf/open/floor/rogue/ruinedwood,
/area/rogue/under/tomb)
"Fm" = (
/obj/structure/rack/rogue/shelf,
/turf/open/floor/rogue/ruinedwood/chevron,
/area/rogue/under/tomb)
"Ft" = (
/obj/item/chair/rogue,
/turf/open/floor/rogue/ruinedwood/chevron,
/area/rogue/under/tomb)
"Gu" = (
/turf/open/floor/rogue/ruinedwood/chevron,
/area/rogue/under/tomb)
"HK" = (
/obj/effect/decal/cleanable/blood,
/turf/open/floor/rogue/metal,
/area/rogue/under/tomb)
"HQ" = (
/turf/closed/wall/mineral/rogue/wooddark/vertical,
/area/rogue/under/tomb)
"IM" = (
/obj/structure/stairs{
	dir = 4
	},
/turf/open/floor/rogue/dirt,
/area/rogue/under/tomb)
"IO" = (
/obj/effect/decal/cleanable/debris/glassy,
/turf/closed/wall/mineral/rogue/wooddark/vertical,
/area/rogue/under/tomb)
"Jx" = (
/obj/structure/bars,
/turf/open/floor/rogue/metal,
/area/rogue/under/tomb)
"KA" = (
/obj/machinery/light/rogue/torchholder/l,
/turf/open/floor/rogue/dirt,
/area/rogue/under/tomb)
"Ln" = (
/turf/open/water,
/area/rogue/under/tomb)
"Mh" = (
/obj/effect/decal/cleanable/dirt,
/turf/open/floor/rogue/ruinedwood/chevron,
/area/rogue/under/tomb)
"Mk" = (
/obj/effect/decal/cleanable/blood/tracks{
	dir = 4
	},
/turf/open/floor/rogue/metal,
/area/rogue/under/tomb)
"MJ" = (
/obj/structure/stairs{
	dir = 4
	},
/turf/open/floor/rogue/ruinedwood,
/area/rogue/under/tomb)
"MK" = (
/obj/effect/decal/cleanable/blood/old,
/turf/open/floor/rogue/metal,
/area/rogue/under/tomb)
"OB" = (
/obj/structure/closet/crate/chest/gold,
/obj/effect/spawner/lootdrop/random_gem,
/obj/effect/spawner/lootdrop/random_gem,
/turf/open/floor/rogue/metal,
/area/rogue/under/tomb)
"Pd" = (
/obj/structure/stairs{
	dir = 4
	},
/turf/open/floor/rogue/ruinedwood/chevron,
/area/rogue/under/tomb)
"Ql" = (
/obj/effect/decal/cleanable/blood/splatter,
/turf/open/floor/rogue/metal,
/area/rogue/under/tomb)
"Qq" = (
/turf/closed/mineral/rogue/bedrock,
/area/rogue/under/tomb)
"Si" = (
/obj/machinery/light/rogue/torchholder/c,
/turf/open/floor/rogue/dirt,
/area/rogue/under/tomb)
"Sp" = (
/obj/machinery/light/rogue/torchholder/c,
/turf/open/floor/rogue/ruinedwood/chevron,
/area/rogue/under/tomb)
"Tl" = (
/obj/structure/rack/rogue/shelf{
	pixel_y = -32
	},
/turf/open/floor/rogue/ruinedwood/chevron,
/area/rogue/under/tomb)
"TV" = (
/obj/structure/fluff/railing/wood{
	dir = 4
	},
/turf/open/floor/rogue/ruinedwood/chevron,
/area/rogue/under/tomb)
"Ui" = (
/obj/structure/mineral_door/wood,
/turf/open/floor/rogue/ruinedwood/chevron,
/area/rogue/under/tomb)
"VO" = (
/turf/open/transparent/openspace,
/area/rogue/under/tomb)
"VV" = (
/turf/open/floor/rogue/ruinedwood,
/area/rogue/under/tomb)
"XR" = (
/obj/item/reagent_containers/glass/bottle/rogue/whitewine,
/turf/closed/mineral/rogue/bedrock,
/area/rogue/under/tomb)
"ZC" = (
/obj/machinery/light/rogue/torchholder/r,
/turf/open/floor/rogue/ruinedwood/chevron,
/area/rogue/under/tomb)

(1,1,1) = {"
Qq
Qq
Qq
Qq
Qq
Qq
rz
AZ
rz
Qq
Qq
Qq
Qq
Qq
Qq
"}
(2,1,1) = {"
Qq
rz
rz
rz
rz
Ez
VV
rz
rz
KA
rz
rz
rz
rz
Qq
"}
(3,1,1) = {"
Qq
rz
rz
rz
VV
rz
VV
rz
VV
rz
rz
VV
VV
VV
Qq
"}
(4,1,1) = {"
Qq
rz
rz
lE
lE
lE
in
lE
VV
lE
lE
lE
VV
rz
Qq
"}
(5,1,1) = {"
Qq
rz
VV
lE
Jx
Jx
qW
Jx
qW
Jx
Jx
lE
rz
rz
Qq
"}
(6,1,1) = {"
Qq
rz
rz
lE
Jx
bc
Mk
bc
Ql
MK
Jx
lE
VV
rz
Qq
"}
(7,1,1) = {"
Qq
rz
VV
lE
Jx
bc
wj
Ln
bc
ah
Jx
lE
VV
VV
Qq
"}
(8,1,1) = {"
Qq
Si
VV
lE
Jx
bc
HK
bc
Ql
bc
Jx
lE
rz
BJ
Qq
"}
(9,1,1) = {"
Qq
VV
VV
lE
Jx
fd
bc
Ql
HK
iz
Jx
lE
rz
rz
Qq
"}
(10,1,1) = {"
Qq
IM
rz
lE
Jx
ah
bc
bc
Ql
wj
Jx
lE
VV
MJ
Qq
"}
(11,1,1) = {"
Qq
wg
rz
lE
Jx
MK
bc
HK
bc
wj
Jx
lE
rz
wg
Qq
"}
(12,1,1) = {"
Qq
rz
VV
lE
Jx
bc
bc
bc
bc
Mk
Jx
lE
rz
rz
Qq
"}
(13,1,1) = {"
Qq
Si
rz
lE
Jx
fd
fd
bc
bc
HK
Jx
lE
rz
BJ
Qq
"}
(14,1,1) = {"
Qq
rz
rz
lE
Jx
HK
bc
bc
bc
fd
Jx
lE
rz
rz
Qq
"}
(15,1,1) = {"
Qq
rz
VV
lE
Jx
ks
bc
ry
bc
OB
Jx
lE
VV
rz
Qq
"}
(16,1,1) = {"
Qq
VV
VV
lE
Jx
Jx
Jx
Jx
Jx
Jx
Jx
lE
VV
VV
Qq
"}
(17,1,1) = {"
Qq
VV
VV
lE
lE
lE
lE
lE
lE
lE
lE
lE
rz
VV
Qq
"}
(18,1,1) = {"
Qq
rz
VV
rz
VV
rz
rz
VV
rz
rz
VV
VV
rz
rz
Qq
"}
(19,1,1) = {"
Qq
rz
rz
rz
rz
dA
rz
rz
rz
dA
rz
rz
rz
rz
Qq
"}
(20,1,1) = {"
Qq
Qq
Qq
Qq
Qq
Qq
rz
kp
rz
Qq
Qq
Qq
Qq
Qq
Qq
"}

(1,1,2) = {"
Qq
Qq
Qq
Qq
Qq
Qq
Gu
Gu
Gu
Qq
Qq
Qq
Qq
Qq
Qq
"}
(2,1,2) = {"
Qq
IO
HQ
HQ
HQ
wg
Ui
wg
Ui
wg
HQ
HQ
HQ
HQ
Qq
"}
(3,1,2) = {"
Qq
Fm
Gu
Gu
ep
Gu
Gu
Gu
Gu
Gu
ep
Mh
Mh
Tl
XR
"}
(4,1,2) = {"
Qq
Fm
Gu
Gu
Gu
Gu
Gu
Gu
Gu
Gu
Gu
Gu
Mh
dm
Qq
"}
(5,1,2) = {"
Qq
Fm
Gu
Gu
Jx
Jx
Jx
CF
Jx
Jx
Jx
Gu
Gu
Tl
Qq
"}
(6,1,2) = {"
Qq
Gu
uf
hG
Jx
VO
VO
VV
VO
VO
Jx
sC
sC
Gu
Qq
"}
(7,1,2) = {"
Qq
Gu
ey
ic
Jx
VO
VO
VO
VO
VO
Jx
Ft
sC
Gu
Qq
"}
(8,1,2) = {"
Qq
Sp
Ft
hG
Jx
VO
VO
sz
VO
VO
Jx
sC
sC
gj
Qq
"}
(9,1,2) = {"
Qq
TV
ey
hG
Jx
VO
VO
VO
VO
VO
Jx
sC
sC
TV
Qq
"}
(10,1,2) = {"
Qq
VO
Be
Gu
Jx
VO
VO
VO
VO
VO
Jx
Gu
vC
VO
Qq
"}
(11,1,2) = {"
Qq
Pd
Be
Gu
Jx
VO
VO
VO
VO
VO
Jx
Gu
vC
Pd
Qq
"}
(12,1,2) = {"
Qq
mB
Gu
Gu
Jx
VO
VO
VO
VO
VO
Jx
Gu
Gu
Gu
Qq
"}
(13,1,2) = {"
Qq
Sp
hG
hG
Jx
VO
VO
sz
VO
VO
Jx
Ft
sC
gj
Qq
"}
(14,1,2) = {"
Qq
Gu
hG
uf
Jx
VO
VO
VO
VO
VO
Jx
sC
sC
Gu
Qq
"}
(15,1,2) = {"
Qq
Gu
hG
Ft
Jx
VO
VO
VO
VO
VO
Jx
sC
sC
Gu
Qq
"}
(16,1,2) = {"
Qq
Fm
Gu
Gu
Jx
Jx
Jx
Jx
Jx
Jx
Jx
Gu
Gu
Tl
Qq
"}
(17,1,2) = {"
Qq
Fm
Gu
Gu
Gu
nH
nH
Gu
nH
nH
Gu
Gu
Mh
Tl
Qq
"}
(18,1,2) = {"
Bw
Fm
Gu
Gu
lh
nH
Ft
Gu
nH
nH
ZC
Gu
Mh
dm
Qq
"}
(19,1,2) = {"
Qq
HQ
HQ
HQ
HQ
wg
Ui
wg
Ui
wg
HQ
HQ
HQ
HQ
Qq
"}
(20,1,2) = {"
Qq
Qq
Qq
Qq
Qq
Qq
Gu
Gu
Gu
Qq
Qq
Qq
Qq
Qq
Qq
"}
