//MAP CONVERTED BY dmm2tgm.py THIS HEADER COMMENT PREVENTS RECONVERSION, DO NOT REMOVE
"ao" = (
/obj/structure/fluff/railing/border,
/obj/structure/table/vtable,
/obj/item/reagent_containers/glass/cup/golden{
	pixel_y = 8;
	pixel_x = -5
	},
/obj/item/reagent_containers/glass/bottle/rogue/redwine{
	pixel_y = 12;
	pixel_x = 7
	},
/turf/open/floor/rogue/ruinedwood/spiral,
/area/rogue/under/tomb/indoors)
"aX" = (
/obj/item/reagent_containers/food/snacks/rogue/meat/sausage/cooked,
/obj/structure/table/wood{
	icon_state = "longtable"
	},
/turf/open/floor/rogue/hexstone,
/area/rogue/under/tomb)
"aY" = (
/obj/structure/fluff/railing/border{
	icon_state = "border";
	dir = 1
	},
/obj/structure/chair/bench/church{
	dir = 1
	},
/turf/open/floor/rogue/ruinedwood/spiral,
/area/rogue/under/tomb)
"cL" = (
/mob/living/carbon/human/species/goblin/npc/ambush/sea,
/turf/open/floor/rogue/hexstone,
/area/rogue/under/tomb/indoors)
"cP" = (
/obj/structure/table/wood{
	dir = 1;
	icon_state = "longtable_mid"
	},
/turf/open/floor/rogue/hexstone,
/area/rogue/under/tomb)
"do" = (
/obj/structure/rack/rogue/shelf/big,
/obj/item/reagent_containers/glass/cup/silver{
	pixel_x = 6;
	pixel_y = 19
	},
/obj/item/reagent_containers/glass/cup/silver{
	pixel_y = 21;
	pixel_x = -6
	},
/turf/open/floor/rogue/ruinedwood/spiral,
/area/rogue/under/tomb)
"ej" = (
/obj/structure/fermentation_keg/random/beer,
/turf/open/floor/rogue/ruinedwood/spiral,
/area/rogue/under/tomb)
"eo" = (
/mob/living/carbon/human/species/orc/npc/marauder,
/turf/open/floor/rogue/hexstone,
/area/rogue/under/tomb/indoors)
"eN" = (
/obj/structure/chair/bench/church/smallbench{
	dir = 4
	},
/mob/living/carbon/human/species/skeleton/npc/no_equipment,
/turf/open/floor/rogue/ruinedwood/spiral,
/area/rogue/under/tomb)
"ff" = (
/obj/effect/decal/cleanable/blood/splatter,
/turf/open/floor/rogue/hexstone,
/area/rogue/under/tomb/indoors)
"fp" = (
/obj/machinery/light/rogue/forge,
/obj/item/rogueweapon/tongs,
/turf/open/floor/rogue/hexstone,
/area/rogue/under/tomb)
"fw" = (
/obj/structure/chair/bench/couchablack/r,
/mob/living/carbon/human/species/skeleton/npc/bogguard{
	name = "Lord of the Pit"
	},
/turf/open/floor/rogue/ruinedwood/spiral,
/area/rogue/under/tomb/indoors)
"fN" = (
/obj/structure/stairs/stone{
	dir = 1
	},
/turf/open/floor/rogue/ruinedwood/spiral,
/area/rogue/under/tomb)
"gt" = (
/turf/closed/wall/mineral/rogue/stonebrick,
/area/rogue/under/tomb/indoors)
"gu" = (
/obj/structure/fluff/railing/border{
	dir = 9;
	icon_state = "border"
	},
/turf/open/floor/rogue/ruinedwood/spiral,
/area/rogue/under/tomb)
"gS" = (
/turf/open/floor/rogue/ruinedwood/spiral,
/area/rogue/under/tomb)
"hs" = (
/obj/machinery/light/rogue/torchholder/l,
/turf/open/floor/rogue/hexstone,
/area/rogue/under/tomb/indoors)
"hw" = (
/obj/effect/decal/cleanable/blood/tracks,
/turf/open/floor/rogue/hexstone,
/area/rogue/under/tomb/indoors)
"iy" = (
/obj/structure/mineral_door/wood,
/obj/effect/mapping_helpers/access/locker,
/turf/open/floor/rogue/hexstone,
/area/rogue/under/tomb/indoors)
"iJ" = (
/obj/item/ingot/iron,
/obj/item/ingot/iron{
	pixel_y = -2;
	pixel_x = 12
	},
/obj/item/ingot/iron{
	pixel_y = 5;
	pixel_x = 7
	},
/turf/open/floor/rogue/hexstone,
/area/rogue/under/tomb)
"jk" = (
/obj/structure/rack/rogue/shelf/biggest,
/obj/item/reagent_containers/glass/bottle/rogue/strongpoison,
/turf/open/floor/rogue/ruinedwood/spiral,
/area/rogue/under/tomb/indoors)
"kc" = (
/obj/structure/fermentation_keg/random/water,
/turf/open/floor/rogue/ruinedwood/spiral,
/area/rogue/under/tomb)
"kF" = (
/obj/effect/decal/cleanable/blood/gibs,
/turf/open/floor/rogue/hexstone,
/area/rogue/under/tomb/indoors)
"kN" = (
/obj/structure/fluff/walldeco/bsmith,
/turf/open/floor/rogue/hexstone,
/area/rogue/under/tomb)
"kR" = (
/obj/structure/fluff/railing/border{
	icon_state = "border";
	dir = 1
	},
/obj/structure/chair/bench/church/r,
/turf/open/floor/rogue/ruinedwood/spiral,
/area/rogue/under/tomb)
"lc" = (
/obj/item/reagent_containers/glass/cup/skull,
/obj/structure/table/wood{
	dir = 8;
	icon_state = "longtable"
	},
/turf/open/floor/rogue/ruinedwood/spiral,
/area/rogue/under/tomb)
"lR" = (
/obj/item/rogueweapon/sword/iron,
/turf/open/floor/rogue/hexstone,
/area/rogue/under/tomb/indoors)
"lW" = (
/turf/open/floor/rogue/hexstone,
/area/rogue/under/tomb)
"mD" = (
/mob/living/carbon/human/species/goblin/npc/hell{
	name = "Weinerman"
	},
/turf/open/floor/rogue/hexstone,
/area/rogue/under/tomb)
"mT" = (
/obj/structure/chair/bench/church/mid,
/mob/living/carbon/human/species/skeleton/npc/mediumspread,
/turf/open/floor/rogue/ruinedwood/spiral,
/area/rogue/under/tomb)
"nb" = (
/obj/machinery/light/rogue/torchholder/r,
/turf/open/floor/rogue/hexstone,
/area/rogue/under/tomb/indoors)
"nl" = (
/obj/structure/stairs/stone,
/turf/open/floor/rogue/ruinedwood/spiral,
/area/rogue/under/tomb)
"nS" = (
/obj/structure/fluff/walldeco/stone,
/turf/closed/wall/mineral/rogue/stone/window/moss,
/area/rogue/under/tomb)
"nW" = (
/obj/structure/mineral_door/wood/window{
	dir = 8
	},
/obj/effect/mapping_helpers/access/locker,
/turf/open/floor/rogue/ruinedwood/spiral,
/area/rogue/under/tomb/indoors)
"ok" = (
/obj/item/reagent_containers/food/snacks/rogue/meat/sausage/cooked{
	pixel_y = 5;
	pixel_x = -7
	},
/obj/structure/table/wood{
	dir = 1;
	icon_state = "longtable_mid"
	},
/turf/open/floor/rogue/hexstone,
/area/rogue/under/tomb)
"oP" = (
/obj/item/natural/stone{
	pixel_y = 5
	},
/mob/living/carbon/human/species/orc/npc/footsoldier{
	name = "Slambo"
	},
/turf/open/floor/rogue/hexstone,
/area/rogue/under/tomb)
"pV" = (
/obj/effect/decal/cleanable/blood/gibs/up,
/turf/open/floor/rogue/hexstone,
/area/rogue/under/tomb/indoors)
"qH" = (
/obj/item/reagent_containers/glass/cup/skull,
/obj/structure/table/wood{
	icon_state = "longtable_mid"
	},
/turf/open/floor/rogue/ruinedwood/spiral,
/area/rogue/under/tomb)
"qZ" = (
/obj/structure/mineral_door/wood/window{
	dir = 4
	},
/obj/effect/mapping_helpers/access/locker,
/turf/open/floor/rogue/hexstone,
/area/rogue/under/tomb/indoors)
"rc" = (
/obj/item/reagent_containers/food/snacks/rogue/biscuit,
/obj/item/reagent_containers/food/snacks/rogue/biscuit,
/obj/item/reagent_containers/food/snacks/rogue/biscuit{
	pixel_x = 12
	},
/obj/item/reagent_containers/food/snacks/rogue/biscuit{
	pixel_y = 5;
	pixel_x = 8
	},
/obj/item/reagent_containers/food/snacks/rogue/biscuit{
	pixel_y = 12;
	pixel_x = 9
	},
/obj/structure/table/wood{
	dir = 1;
	icon_state = "longtable_mid"
	},
/turf/open/floor/rogue/hexstone,
/area/rogue/under/tomb)
"rI" = (
/obj/structure/table/wood{
	icon_state = "longtable_mid"
	},
/turf/open/floor/rogue/ruinedwood/spiral,
/area/rogue/under/tomb)
"sr" = (
/obj/structure/chair/bench/church/smallbench{
	dir = 4
	},
/obj/structure/fluff/railing/border,
/turf/open/floor/rogue/ruinedwood/spiral,
/area/rogue/under/tomb)
"sw" = (
/obj/item/natural/poo,
/obj/effect/decal/cleanable/blood/splatter,
/mob/living/carbon/human/species/skeleton/npc/mediumspread,
/turf/open/floor/rogue/hexstone,
/area/rogue/under/tomb/indoors)
"sy" = (
/obj/structure/fluff/railing/border{
	icon_state = "border";
	dir = 1
	},
/obj/structure/chair/bench/church/mid,
/mob/living/carbon/human/species/skeleton/npc/no_equipment,
/turf/open/floor/rogue/ruinedwood/spiral,
/area/rogue/under/tomb)
"sE" = (
/obj/item/clothing/gloves/roguetown/chain/iron,
/turf/open/floor/rogue/hexstone,
/area/rogue/under/tomb/indoors)
"tW" = (
/obj/structure/fluff/railing/border,
/turf/open/floor/rogue/ruinedwood/spiral,
/area/rogue/under/tomb/indoors)
"uS" = (
/obj/structure/fluff/railing/border{
	icon_state = "border";
	dir = 4
	},
/turf/open/floor/rogue/ruinedwood/spiral,
/area/rogue/under/tomb)
"vh" = (
/obj/structure/fluff/railing/border,
/obj/structure/table/vtable/v2,
/obj/item/reagent_containers/glass/cup/golden{
	pixel_y = 8;
	pixel_x = 8
	},
/obj/item/rogueweapon/sword/decorated{
	pixel_x = -5;
	pixel_y = 8
	},
/obj/effect/spawner/lootdrop/random_gem,
/obj/effect/spawner/lootdrop/random_gem{
	pixel_x = -11;
	pixel_y = 11
	},
/turf/open/floor/rogue/ruinedwood/spiral,
/area/rogue/under/tomb/indoors)
"vG" = (
/turf/open/floor/rogue/hexstone,
/area/rogue/under/tomb/indoors)
"wU" = (
/obj/structure/mineral_door/wood/window{
	dir = 8
	},
/obj/effect/mapping_helpers/access/locker,
/turf/open/floor/rogue/hexstone,
/area/rogue/under/tomb/indoors)
"wY" = (
/obj/item/clothing/shoes/roguetown/boots/leather/reinforced,
/obj/structure/fluff/walldeco/chains,
/turf/open/floor/rogue/hexstone,
/area/rogue/under/tomb/indoors)
"xp" = (
/turf/closed/mineral/rogue/bedrock,
/area/rogue/under/tomb)
"xK" = (
/obj/structure/rack/rogue/shelf/biggest,
/obj/item/rogueweapon/spear/billhook,
/obj/item/rogueweapon/spear/billhook{
	pixel_y = -8
	},
/turf/open/floor/rogue/hexstone,
/area/rogue/under/tomb)
"xR" = (
/obj/structure/mineral_door/wood/window{
	dir = 4
	},
/obj/effect/mapping_helpers/access/locker,
/turf/open/floor/rogue/ruinedwood/spiral,
/area/rogue/under/tomb)
"yn" = (
/obj/item/reagent_containers/food/snacks/rogue/meat/sausage/cooked,
/obj/structure/table/wood{
	dir = 1;
	icon_state = "longtable_mid"
	},
/turf/open/floor/rogue/hexstone,
/area/rogue/under/tomb)
"yO" = (
/mob/living/carbon/human/species/goblin/npc/hell{
	name = "Bobby Baker"
	},
/turf/open/floor/rogue/hexstone,
/area/rogue/under/tomb)
"za" = (
/obj/structure/roguewindow/stained/silver,
/turf/open/floor/rogue/ruinedwood/spiral,
/area/rogue/under/tomb/indoors)
"zb" = (
/turf/closed/wall/mineral/rogue/stonebrick,
/area/rogue/under/tomb)
"zl" = (
/obj/item/rogueore/coal,
/turf/open/floor/rogue/hexstone,
/area/rogue/under/tomb)
"At" = (
/obj/item/restraints/legcuffs/beartrap/armed/camouflage,
/turf/open/floor/rogue/hexstone,
/area/rogue/under/tomb)
"Bm" = (
/obj/structure/chair/bench/church/r,
/turf/open/floor/rogue/ruinedwood/spiral,
/area/rogue/under/tomb)
"Bs" = (
/obj/structure/fluff/railing/border{
	icon_state = "border";
	dir = 1
	},
/obj/structure/chair/bench/church/mid,
/obj/item/clothing/head/peaceflower,
/mob/living/carbon/human/species/skeleton/npc/no_equipment,
/obj/effect/mapping_helpers/floor_clothing_equipper,
/turf/open/floor/rogue/ruinedwood/spiral,
/area/rogue/under/tomb)
"Cw" = (
/obj/effect/spawner/lootdrop/roguetown/dungeon/weapons,
/obj/effect/decal/cleanable/blood,
/turf/open/floor/rogue/hexstone,
/area/rogue/under/tomb/indoors)
"Do" = (
/obj/machinery/light/rogue/torchholder/l,
/mob/living/carbon/human/species/skeleton/npc/hardspread,
/turf/open/floor/rogue/hexstone,
/area/rogue/under/tomb/indoors)
"Dz" = (
/mob/living/carbon/human/species/skeleton/npc/mediumspread,
/turf/open/floor/rogue/ruinedwood/spiral,
/area/rogue/under/tomb)
"Fl" = (
/obj/effect/decal/cleanable/blood/footprints,
/turf/open/floor/rogue/hexstone,
/area/rogue/under/tomb/indoors)
"FZ" = (
/turf/closed/wall/mineral/rogue/stone/window/moss,
/area/rogue/under/tomb/indoors)
"Gf" = (
/obj/structure/fluff/railing/border{
	icon_state = "border";
	dir = 5
	},
/turf/open/floor/rogue/ruinedwood/spiral,
/area/rogue/under/tomb)
"Gs" = (
/obj/structure/chair/bench/church/smallbench{
	dir = 4
	},
/obj/item/clothing/head/peaceflower,
/mob/living/carbon/human/species/skeleton/npc/no_equipment,
/obj/effect/mapping_helpers/floor_clothing_equipper,
/turf/open/floor/rogue/ruinedwood/spiral,
/area/rogue/under/tomb)
"HE" = (
/obj/structure/chair/bench/church/smallbench{
	dir = 4
	},
/mob/living/carbon/human/species/skeleton/npc/mediumspread,
/turf/open/floor/rogue/ruinedwood/spiral,
/area/rogue/under/tomb)
"IJ" = (
/obj/item/reagent_containers/food/snacks/rogue/meat/sausage/cooked{
	pixel_x = 12;
	pixel_y = 11
	},
/obj/structure/table/wood{
	icon_state = "longtable"
	},
/turf/open/floor/rogue/hexstone,
/area/rogue/under/tomb)
"IM" = (
/obj/item/natural/stone,
/obj/item/natural/stone,
/obj/item/natural/stone,
/obj/item/natural/stone{
	pixel_y = 10;
	pixel_x = 10
	},
/obj/machinery/anvil,
/obj/item/rogueweapon/hammer/iron,
/turf/open/floor/rogue/hexstone,
/area/rogue/under/tomb)
"IU" = (
/obj/structure/chair/bench/church/smallbench{
	dir = 4
	},
/obj/structure/fluff/railing/border{
	dir = 10;
	icon_state = "border"
	},
/mob/living/carbon/human/species/skeleton/npc/no_equipment,
/turf/open/floor/rogue/ruinedwood/spiral,
/area/rogue/under/tomb)
"Jl" = (
/obj/effect/dungeon_directional_helper/west,
/turf/open/floor/rogue/hexstone,
/area/rogue/under/tomb)
"Ko" = (
/obj/structure/fluff/railing/border{
	icon_state = "border";
	dir = 1
	},
/turf/open/floor/rogue/ruinedwood/spiral,
/area/rogue/under/tomb)
"KK" = (
/obj/structure/fluff/railing/border{
	icon_state = "border";
	dir = 8
	},
/turf/open/floor/rogue/ruinedwood/spiral,
/area/rogue/under/tomb)
"LC" = (
/obj/effect/dungeon_directional_helper/south,
/turf/open/floor/rogue/hexstone,
/area/rogue/under/tomb)
"Mg" = (
/obj/item/clothing/suit/roguetown/armor/chainmail/iron,
/turf/open/floor/rogue/hexstone,
/area/rogue/under/tomb/indoors)
"Mp" = (
/obj/structure/fluff/railing/border{
	icon_state = "border";
	dir = 5
	},
/obj/structure/table/wood{
	icon_state = "longtable";
	dir = 4
	},
/turf/open/floor/rogue/ruinedwood/spiral,
/area/rogue/under/tomb)
"Np" = (
/obj/structure/fluff/grindwheel,
/turf/open/floor/rogue/hexstone,
/area/rogue/under/tomb)
"NB" = (
/obj/structure/stairs/stone,
/turf/open/floor/rogue/hexstone,
/area/rogue/under/tomb)
"NE" = (
/obj/structure/fluff/railing/border{
	icon_state = "border";
	dir = 6
	},
/turf/open/floor/rogue/ruinedwood/spiral,
/area/rogue/under/tomb)
"Oe" = (
/obj/structure/fluff/railing/border{
	dir = 10;
	icon_state = "border"
	},
/turf/open/floor/rogue/ruinedwood/spiral,
/area/rogue/under/tomb)
"Qy" = (
/turf/open/floor/rogue/ruinedwood/spiral,
/area/rogue/under/tomb/indoors)
"QB" = (
/obj/effect/spawner/lootdrop/roguetown/dungeon/food,
/obj/structure/table/wood{
	dir = 1;
	icon_state = "longtable"
	},
/turf/open/floor/rogue/hexstone,
/area/rogue/under/tomb)
"QJ" = (
/obj/structure/chair/bench/church/mid,
/mob/living/carbon/human/species/skeleton/npc/no_equipment,
/turf/open/floor/rogue/ruinedwood/spiral,
/area/rogue/under/tomb)
"QZ" = (
/obj/effect/decal/cleanable/blood/gibs/limb,
/turf/open/floor/rogue/hexstone,
/area/rogue/under/tomb/indoors)
"SA" = (
/obj/structure/stairs/stone{
	dir = 1
	},
/turf/open/floor/rogue/hexstone,
/area/rogue/under/tomb)
"SC" = (
/obj/structure/rack/rogue/shelf/biggest,
/obj/item/gun/ballistic/revolver/grenadelauncher/bow/longbow,
/obj/item/quiver/arrows,
/turf/open/floor/rogue/ruinedwood/spiral,
/area/rogue/under/tomb/indoors)
"UQ" = (
/turf/open/transparent/openspace,
/area/rogue/under/tomb)
"VC" = (
/obj/structure/rack/rogue/shelf/big,
/turf/open/floor/rogue/hexstone,
/area/rogue/under/tomb)
"Wk" = (
/mob/living/carbon/human/species/skeleton/npc/hardspread,
/turf/open/floor/rogue/hexstone,
/area/rogue/under/tomb/indoors)
"Wt" = (
/turf/open/floor/rogue/rooftop{
	dir = 1
	},
/area/rogue/under/tomb)
"Wv" = (
/obj/structure/bars,
/turf/open/floor/rogue/hexstone,
/area/rogue/under/tomb/indoors)
"Xi" = (
/obj/item/rogueweapon/huntingknife/idagger/steel,
/turf/open/floor/rogue/hexstone,
/area/rogue/under/tomb/indoors)
"XV" = (
/obj/effect/decal/cleanable/blood/gibs/core,
/turf/open/floor/rogue/hexstone,
/area/rogue/under/tomb/indoors)
"Yc" = (
/obj/structure/chair/bench/church/smallbench{
	dir = 4
	},
/turf/open/floor/rogue/ruinedwood/spiral,
/area/rogue/under/tomb)
"Yg" = (
/mob/living/carbon/human/species/skeleton/npc/hardspread,
/turf/open/floor/rogue/ruinedwood/spiral,
/area/rogue/under/tomb)
"Yv" = (
/turf/closed/wall/mineral/rogue/stone/window/moss,
/area/rogue/under/tomb)
"YP" = (
/obj/structure/bed/rogue/shit,
/turf/open/floor/rogue/hexstone,
/area/rogue/under/tomb/indoors)
"YS" = (
/obj/structure/chair/bench/couchablack,
/mob/living/carbon/human/species/skeleton/npc/mediumspread,
/turf/open/floor/rogue/ruinedwood/spiral,
/area/rogue/under/tomb/indoors)
"Zf" = (
/obj/structure/table/wood{
	dir = 1;
	icon_state = "longtable"
	},
/turf/open/floor/rogue/hexstone,
/area/rogue/under/tomb)
"Zw" = (
/obj/structure/chair/bench/church/mid,
/turf/open/floor/rogue/ruinedwood/spiral,
/area/rogue/under/tomb)
"ZO" = (
/obj/structure/chair/bench/church{
	dir = 1
	},
/turf/open/floor/rogue/ruinedwood/spiral,
/area/rogue/under/tomb)

(1,1,1) = {"
xp
xp
xp
xp
xp
xp
xp
lW
lW
Jl
lW
lW
xp
xp
xp
xp
xp
xp
xp
xp
"}
(2,1,1) = {"
xp
lW
lW
lW
lW
lW
lW
lW
lW
lW
lW
lW
lW
lW
lW
lW
lW
lW
lW
xp
"}
(3,1,1) = {"
xp
lW
kN
lW
lW
iJ
Yv
lW
lW
lW
Yv
Yv
Yv
Yv
lW
lW
lW
aX
lW
xp
"}
(4,1,1) = {"
xp
lW
lW
IM
oP
xK
Yv
lW
lW
lW
lW
lW
NB
Yv
lW
lW
lW
rc
lW
xp
"}
(5,1,1) = {"
xp
lW
lW
lW
Np
Yv
nS
lW
At
lW
lW
lW
NB
Yv
Yv
lW
lW
cP
lW
xp
"}
(6,1,1) = {"
xp
lW
zl
fp
Yv
Yv
lW
lW
lW
lW
lW
lW
lW
lW
Yv
Yv
yO
QB
lW
xp
"}
(7,1,1) = {"
xp
lW
Yv
Yv
Yv
lW
lW
lW
gt
gt
qZ
gt
lW
lW
lW
Yv
Yv
Yv
lW
xp
"}
(8,1,1) = {"
xp
lW
lW
lW
lW
lW
lW
gt
vG
cL
hw
Mg
gt
lW
lW
lW
lW
Yv
lW
xp
"}
(9,1,1) = {"
xp
lW
lW
lW
lW
lW
gt
Do
kF
Cw
QZ
Fl
hs
gt
lW
lW
lW
lW
lW
lW
"}
(10,1,1) = {"
xp
lW
lW
lW
lW
lW
Wv
wY
vG
Xi
vG
eo
vG
Wv
lW
lW
lW
lW
lW
lW
"}
(11,1,1) = {"
xp
lW
lW
lW
At
lW
Wv
sw
pV
XV
sE
eo
vG
Wv
lW
lW
lW
lW
lW
LC
"}
(12,1,1) = {"
xp
lW
lW
lW
lW
lW
gt
nb
Wk
vG
lR
vG
nb
gt
lW
At
lW
lW
lW
lW
"}
(13,1,1) = {"
xp
lW
lW
lW
lW
lW
lW
gt
vG
vG
vG
ff
gt
lW
lW
lW
lW
Yv
lW
xp
"}
(14,1,1) = {"
xp
lW
FZ
iy
FZ
lW
lW
lW
gt
wU
gt
gt
lW
lW
lW
Yv
Yv
Yv
lW
xp
"}
(15,1,1) = {"
xp
lW
FZ
vG
FZ
FZ
lW
lW
lW
lW
lW
lW
lW
lW
Yv
Yv
lW
IJ
lW
xp
"}
(16,1,1) = {"
xp
lW
FZ
vG
YP
FZ
FZ
SA
lW
lW
lW
At
lW
Yv
Yv
VC
mD
yn
lW
xp
"}
(17,1,1) = {"
xp
lW
FZ
vG
vG
YP
FZ
SA
lW
lW
lW
lW
lW
Yv
lW
lW
lW
ok
lW
xp
"}
(18,1,1) = {"
xp
lW
FZ
FZ
FZ
FZ
FZ
Yv
Yv
lW
lW
lW
Yv
Yv
lW
lW
lW
Zf
lW
xp
"}
(19,1,1) = {"
xp
lW
lW
lW
lW
lW
lW
lW
lW
lW
lW
lW
lW
lW
lW
lW
lW
lW
lW
xp
"}
(20,1,1) = {"
xp
xp
xp
xp
xp
xp
xp
xp
xp
xp
xp
xp
xp
xp
xp
xp
xp
xp
xp
xp
"}

(1,1,2) = {"
xp
xp
xp
xp
xp
xp
xp
zb
gS
gS
gS
zb
xp
xp
xp
xp
xp
xp
xp
xp
"}
(2,1,2) = {"
xp
UQ
UQ
UQ
UQ
UQ
UQ
zb
gS
gS
gS
zb
UQ
UQ
UQ
UQ
UQ
UQ
UQ
xp
"}
(3,1,2) = {"
xp
UQ
UQ
UQ
UQ
UQ
zb
zb
gS
gS
gS
zb
zb
zb
zb
UQ
UQ
UQ
UQ
xp
"}
(4,1,2) = {"
xp
UQ
UQ
UQ
UQ
UQ
zb
gS
Yc
Yc
Yc
sr
UQ
nl
zb
UQ
UQ
UQ
UQ
xp
"}
(5,1,2) = {"
xp
UQ
UQ
UQ
UQ
zb
zb
gS
HE
eN
Yc
sr
UQ
nl
zb
UQ
UQ
UQ
UQ
xp
"}
(6,1,2) = {"
xp
UQ
UQ
UQ
zb
zb
gS
gS
Gs
Yc
Yc
IU
KK
gS
zb
zb
UQ
UQ
UQ
xp
"}
(7,1,2) = {"
xp
UQ
gt
gt
gt
Yg
gS
NE
uS
uS
uS
uS
Gf
gS
gS
zb
zb
zb
UQ
xp
"}
(8,1,2) = {"
xp
UQ
gt
jk
gt
xR
zb
zb
UQ
UQ
UQ
UQ
zb
Gf
gS
gS
gS
zb
zb
zb
"}
(9,1,2) = {"
xp
UQ
za
Qy
Qy
Qy
tW
UQ
UQ
UQ
UQ
UQ
UQ
aY
ZO
ZO
gS
gS
gS
gS
"}
(10,1,2) = {"
xp
UQ
gt
Qy
Qy
YS
ao
UQ
UQ
UQ
UQ
UQ
UQ
sy
Zw
Zw
gS
gS
gS
gS
"}
(11,1,2) = {"
xp
UQ
gt
Qy
Qy
fw
vh
UQ
UQ
UQ
UQ
UQ
UQ
Bs
QJ
mT
gS
gS
gS
gS
"}
(12,1,2) = {"
xp
UQ
za
Qy
Qy
Qy
tW
UQ
UQ
UQ
UQ
UQ
UQ
kR
Bm
Bm
gS
gS
gS
gS
"}
(13,1,2) = {"
xp
UQ
gt
SC
gt
nW
gt
zb
UQ
UQ
UQ
UQ
zb
gS
gS
gS
gS
zb
zb
zb
"}
(14,1,2) = {"
xp
UQ
gt
gt
gt
Yg
gS
Oe
KK
KK
KK
KK
gu
gS
gS
zb
zb
zb
UQ
xp
"}
(15,1,2) = {"
xp
UQ
Wt
Wt
zb
zb
gS
uS
Mp
qH
rI
lc
gS
gS
zb
zb
UQ
UQ
UQ
xp
"}
(16,1,2) = {"
xp
UQ
Wt
Wt
Wt
zb
fN
UQ
Ko
gS
gS
gS
gS
zb
zb
UQ
UQ
UQ
UQ
xp
"}
(17,1,2) = {"
xp
UQ
Wt
Wt
Wt
zb
fN
UQ
Ko
do
Dz
kc
ej
zb
UQ
UQ
UQ
UQ
UQ
xp
"}
(18,1,2) = {"
xp
UQ
Wt
Wt
Wt
zb
zb
zb
zb
zb
zb
zb
zb
zb
UQ
UQ
UQ
UQ
UQ
xp
"}
(19,1,2) = {"
xp
UQ
UQ
UQ
UQ
UQ
UQ
UQ
UQ
UQ
UQ
UQ
UQ
UQ
UQ
UQ
UQ
UQ
UQ
xp
"}
(20,1,2) = {"
xp
xp
xp
xp
xp
xp
xp
xp
xp
xp
xp
xp
xp
xp
xp
xp
xp
xp
xp
xp
"}
