//MAP CONVERTED BY dmm2tgm.py THIS HEADER COMMENT PREVENTS RECONVERSION, DO NOT REMOVE
"ah" = (
/obj/structure/rack/rogue/shelf/big,
/turf/open/floor/rogue/ruinedwood/spiral,
/area/rogue/under/tomb/indoors)
"aB" = (
/obj/structure/fluff/railing/border,
/obj/structure/fluff/railing/border,
/turf/open/floor/rogue/ruinedwood/spiral,
/area/rogue/under/tomb/indoors)
"bh" = (
/obj/structure/roguewindow,
/obj/structure/fluff/walldeco/vinez,
/turf/open/floor/rogue/ruinedwood/spiral,
/area/rogue/under/tomb/indoors)
"bp" = (
/turf/open/floor/rogue/rooftop/green{
	dir = 4
	},
/area/rogue/under/tomb)
"dU" = (
/obj/structure/mineral_door/wood/deadbolt{
	dir = 1
	},
/obj/item/soap,
/turf/open/floor/rogue/ruinedwood/spiral,
/area/rogue/under/tomb/indoors)
"er" = (
/obj/structure/fluff/railing/border{
	dir = 6
	},
/turf/open/floor/rogue/ruinedwood/spiral,
/area/rogue/under/tomb/indoors)
"eZ" = (
/obj/structure/fluff/railing/border{
	dir = 10
	},
/turf/open/floor/rogue/ruinedwood/spiral,
/area/rogue/under/tomb/indoors)
"fO" = (
/obj/structure/chair/stool/rogue,
/turf/open/floor/rogue/ruinedwood/spiral,
/area/rogue/under/tomb/indoors)
"gz" = (
/obj/structure/roguewindow,
/turf/open/floor/rogue/ruinedwood/spiral,
/area/rogue/under/tomb/indoors)
"gS" = (
/obj/structure/chair/wood{
	dir = 4
	},
/turf/open/floor/rogue/ruinedwood/spiral,
/area/rogue/under/tomb/indoors)
"ha" = (
/obj/structure/table/wood{
	icon_state = "tablewood1"
	},
/turf/open/floor/rogue/ruinedwood/spiral,
/area/rogue/under/tomb/indoors)
"hi" = (
/obj/structure/closet/crate/drawer/inn,
/turf/open/floor/rogue/ruinedwood/spiral,
/area/rogue/under/tomb/indoors)
"hm" = (
/obj/item/rogueweapon/huntingknife/cleaver,
/obj/structure/fluff/walldeco/bigpainting/lake,
/obj/structure/table/wood{
	icon_state = "longtable"
	},
/turf/open/floor/rogue/ruinedwood/spiral,
/area/rogue/under/tomb/indoors)
"ih" = (
/obj/structure/fluff/walldeco/sign/saiga,
/turf/open/floor/rogue/dirt,
/area/rogue/under/tomb)
"is" = (
/obj/item/reagent_containers/glass/cup/wooden/crafted{
	pixel_y = -5;
	pixel_x = 13
	},
/obj/structure/table/wood{
	icon_state = "tablewood1"
	},
/turf/open/floor/rogue/ruinedwood/spiral,
/area/rogue/under/tomb/indoors)
"jH" = (
/obj/item/reagent_containers/glass/bottle/rogue/wine/sourwine{
	pixel_y = 9
	},
/obj/item/reagent_containers/glass/bottle/rogue/wine/sourwine{
	pixel_y = 5;
	pixel_x = -7
	},
/obj/item/reagent_containers/glass/bottle/rogue/poison{
	pixel_y = 7;
	pixel_x = 8
	},
/obj/structure/table/wood{
	dir = 1;
	icon_state = "longtable"
	},
/turf/open/floor/rogue/ruinedwood/spiral,
/area/rogue/under/tomb/indoors)
"kl" = (
/obj/effect/spawner/lootdrop/roguetown/dungeon/food,
/obj/structure/table/wood{
	icon_state = "tablewood1"
	},
/turf/open/floor/rogue/ruinedwood/spiral,
/area/rogue/under/tomb/indoors)
"kA" = (
/turf/open/floor/rogue/rooftop/green,
/area/rogue/under/tomb)
"lU" = (
/turf/open/floor/rogue/ruinedwood/spiral,
/area/rogue/under/tomb/indoors)
"mI" = (
/mob/living/carbon/human/species/orc/npc/marauder,
/turf/open/floor/rogue/ruinedwood/spiral,
/area/rogue/under/tomb/indoors)
"nC" = (
/obj/structure/fluff/walldeco/vinez/offset,
/turf/open/floor/rogue/ruinedwood/spiral,
/area/rogue/under/tomb/indoors)
"nK" = (
/obj/structure/mineral_door/wood/window,
/turf/open/floor/rogue/ruinedwood/spiral,
/area/rogue/under/tomb/indoors)
"nW" = (
/obj/item/reagent_containers/glass/cup/wooden/crafted{
	pixel_x = 9
	},
/obj/structure/table/wood{
	icon_state = "tablewood1"
	},
/turf/open/floor/rogue/ruinedwood/spiral,
/area/rogue/under/tomb/indoors)
"oa" = (
/obj/structure/fluff/railing/border{
	dir = 9
	},
/turf/open/floor/rogue/ruinedwood/spiral,
/area/rogue/under/tomb/indoors)
"oq" = (
/obj/machinery/light/rogue/hearth,
/obj/item/reagent_containers/glass/bucket/pot,
/turf/open/floor/rogue/ruinedwood/spiral,
/area/rogue/under/tomb/indoors)
"qO" = (
/turf/open/floor/rogue/naturalstone,
/area/rogue/under/tomb/indoors)
"rA" = (
/obj/structure/well,
/turf/open/floor/rogue/dirt,
/area/rogue/under/tomb)
"rI" = (
/obj/effect/dungeon_directional_helper/north,
/turf/open/floor/rogue/naturalstone,
/area/rogue/under/tomb)
"rK" = (
/obj/structure/roguewindow/openclose{
	dir = 8
	},
/turf/open/floor/rogue/ruinedwood/spiral,
/area/rogue/under/tomb/indoors)
"sd" = (
/obj/structure/fluff/walldeco/vinez,
/turf/closed/wall/mineral/rogue/decowood/vert,
/area/rogue/under/tomb/indoors)
"sh" = (
/obj/structure/roguewindow/openclose{
	dir = 1
	},
/turf/open/floor/rogue/ruinedwood/spiral,
/area/rogue/under/tomb/indoors)
"st" = (
/turf/open/floor/rogue/dirt,
/area/rogue/under/tomb/indoors)
"sC" = (
/obj/structure/chair/stool/rogue{
	pixel_x = 3;
	pixel_y = -1
	},
/turf/open/floor/rogue/ruinedwood/spiral,
/area/rogue/under/tomb/indoors)
"tu" = (
/turf/open/floor/rogue/dirt,
/area/rogue/under/tomb)
"tA" = (
/obj/structure/fluff/walldeco/vinez/r,
/turf/open/floor/rogue/ruinedwood/spiral,
/area/rogue/under/tomb/indoors)
"tN" = (
/obj/structure/fluff/railing/border{
	dir = 1
	},
/turf/open/floor/rogue/ruinedwood/spiral,
/area/rogue/under/tomb/indoors)
"tP" = (
/turf/closed/mineral/rogue/bedrock,
/area/rogue/under/tomb)
"uh" = (
/obj/structure/fluff/walldeco/painting/queen,
/turf/closed/wall/mineral/rogue/decowood,
/area/rogue/under/tomb/indoors)
"ur" = (
/obj/item/reagent_containers/glass/cup/wooden/crafted{
	pixel_x = -6;
	pixel_y = 16
	},
/obj/structure/table/wood{
	icon_state = "tablewood1"
	},
/turf/open/floor/rogue/ruinedwood/spiral,
/area/rogue/under/tomb/indoors)
"uG" = (
/obj/structure/fluff/railing/border{
	dir = 5
	},
/turf/open/floor/rogue/ruinedwood/spiral,
/area/rogue/under/tomb/indoors)
"vh" = (
/obj/structure/chair/stool/rogue{
	pixel_x = -5
	},
/turf/open/floor/rogue/ruinedwood/spiral,
/area/rogue/under/tomb/indoors)
"wR" = (
/obj/structure/fluff/walldeco/vinez/r,
/obj/structure/fluff/railing/border{
	dir = 9
	},
/turf/open/floor/rogue/ruinedwood/spiral,
/area/rogue/under/tomb/indoors)
"yc" = (
/obj/machinery/light/rogue/chand,
/obj/item/clothing/ring/silver,
/turf/open/transparent/openspace,
/area/rogue/under/tomb/indoors)
"ye" = (
/obj/structure/fluff/railing/border{
	dir = 8
	},
/turf/open/floor/rogue/ruinedwood/spiral,
/area/rogue/under/tomb/indoors)
"yH" = (
/turf/open/transparent/openspace,
/area/rogue/under/tomb/indoors)
"AX" = (
/turf/closed/wall/mineral/rogue/decowood/vert,
/area/rogue/under/tomb/indoors)
"Bz" = (
/mob/living/carbon/human/species/skeleton/npc/supereasy,
/turf/open/water/bath,
/area/rogue/under/tomb/indoors)
"BG" = (
/obj/structure/table/wood{
	icon_state = "longtable_mid"
	},
/turf/open/floor/rogue/ruinedwood/spiral,
/area/rogue/under/tomb/indoors)
"BZ" = (
/obj/machinery/light/rogue/torchholder/l,
/obj/structure/fluff/walldeco/vinez/l,
/turf/open/floor/rogue/ruinedwood/spiral,
/area/rogue/under/tomb/indoors)
"Cb" = (
/obj/structure/floordoor/gatehatch/inner,
/turf/open/floor/rogue/dirt,
/area/rogue/under/tomb)
"CW" = (
/obj/structure/roguewindow/openclose,
/turf/open/floor/rogue/ruinedwood/spiral,
/area/rogue/under/tomb/indoors)
"Dk" = (
/obj/structure/fluff/railing/border,
/turf/open/floor/rogue/ruinedwood/spiral,
/area/rogue/under/tomb/indoors)
"Do" = (
/obj/structure/bars/pipe/left,
/mob/living/carbon/human/species/skeleton/npc/supereasy,
/turf/open/water/bath,
/area/rogue/under/tomb/indoors)
"Du" = (
/obj/structure/table/wood{
	dir = 8;
	icon_state = "longtable"
	},
/turf/open/floor/rogue/ruinedwood/spiral,
/area/rogue/under/tomb/indoors)
"Dx" = (
/obj/structure/bed/rogue/inn/double,
/turf/open/floor/rogue/ruinedwood/spiral,
/area/rogue/under/tomb/indoors)
"EK" = (
/obj/effect/dungeon_directional_helper/east,
/turf/open/floor/rogue/naturalstone,
/area/rogue/under/tomb)
"Fa" = (
/turf/open/floor/rogue/rooftop/green{
	dir = 1
	},
/area/rogue/under/tomb)
"Fi" = (
/turf/open/floor/rogue/rooftop/green{
	dir = 8
	},
/area/rogue/under/tomb)
"Fq" = (
/obj/structure/closet/crate/drawer/inn,
/obj/effect/spawner/lootdrop/general_loot_low/x3,
/turf/open/floor/rogue/ruinedwood/spiral,
/area/rogue/under/tomb/indoors)
"Ft" = (
/turf/open/transparent/openspace,
/area/rogue/under/tomb)
"FP" = (
/obj/structure/table/wood{
	icon_state = "tablewood1"
	},
/obj/effect/spawner/lootdrop/general_loot_low,
/turf/open/floor/rogue/ruinedwood/spiral,
/area/rogue/under/tomb/indoors)
"GU" = (
/obj/machinery/light/rogue/torchholder/r,
/turf/open/floor/rogue/ruinedwood/spiral,
/area/rogue/under/tomb/indoors)
"Ha" = (
/obj/structure/bearpelt,
/turf/open/floor/rogue/ruinedwood/spiral,
/area/rogue/under/tomb/indoors)
"Im" = (
/turf/closed/wall/mineral/rogue/stone/moss,
/area/rogue/under/tomb/indoors)
"It" = (
/obj/structure/mineral_door/wood,
/turf/open/floor/rogue/ruinedwood/spiral,
/area/rogue/under/tomb/indoors)
"KB" = (
/obj/structure/fluff/railing/border{
	dir = 4
	},
/turf/open/floor/rogue/ruinedwood/spiral,
/area/rogue/under/tomb/indoors)
"Ly" = (
/obj/structure/stairs/d{
	dir = 4
	},
/turf/open/floor/rogue/ruinedwood/spiral,
/area/rogue/under/tomb/indoors)
"LC" = (
/obj/structure/chair/wood,
/turf/open/floor/rogue/ruinedwood/spiral,
/area/rogue/under/tomb/indoors)
"MK" = (
/obj/machinery/light/rogue{
	pixel_x = 16
	},
/turf/closed/wall/mineral/rogue/decowood/vert,
/area/rogue/under/tomb/indoors)
"Nc" = (
/obj/structure/rack/rogue/shelf/biggest,
/obj/item/reagent_containers/food/snacks/rogue/meat/salami{
	pixel_y = -2;
	pixel_x = -1
	},
/obj/item/reagent_containers/food/snacks/rogue/meat/salami{
	pixel_x = -2;
	pixel_y = 10
	},
/turf/open/floor/rogue/ruinedwood/spiral,
/area/rogue/under/tomb/indoors)
"Nd" = (
/obj/structure/roguewindow/openclose{
	dir = 4
	},
/turf/open/floor/rogue/ruinedwood/spiral,
/area/rogue/under/tomb/indoors)
"NF" = (
/obj/structure/bed/rogue/inn,
/turf/open/floor/rogue/ruinedwood/spiral,
/area/rogue/under/tomb/indoors)
"Oj" = (
/turf/closed/wall/mineral/rogue/decowood,
/area/rogue/under/tomb/indoors)
"Ov" = (
/obj/effect/dungeon_directional_helper/west,
/turf/open/floor/rogue/naturalstone,
/area/rogue/under/tomb)
"OP" = (
/obj/structure/fermentation_keg/random/beer,
/turf/open/floor/rogue/ruinedwood/spiral,
/area/rogue/under/tomb/indoors)
"Qe" = (
/turf/open/floor/rogue/naturalstone,
/area/rogue/under/tomb)
"Rh" = (
/obj/structure/toilet,
/mob/living/carbon/human/species/orc/npc/berserker,
/turf/open/floor/rogue/ruinedwood/spiral,
/area/rogue/under/tomb/indoors)
"RA" = (
/obj/item/reagent_containers/powder/moondust{
	pixel_x = 5
	},
/obj/item/reagent_containers/powder/moondust{
	pixel_y = -5;
	pixel_x = -13
	},
/obj/effect/decal/cleanable/blood,
/obj/item/rogueweapon/huntingknife{
	pixel_y = -2;
	pixel_x = -14
	},
/turf/open/floor/rogue/ruinedwood/spiral,
/area/rogue/under/tomb/indoors)
"SI" = (
/obj/structure/table/wood{
	icon_state = "longtable_mid"
	},
/obj/effect/spawner/lootdrop/general_loot_low,
/turf/open/floor/rogue/ruinedwood/spiral,
/area/rogue/under/tomb/indoors)
"SM" = (
/obj/structure/mineral_door/wood,
/obj/item/restraints/legcuffs/beartrap/armed,
/turf/open/floor/rogue/ruinedwood/spiral,
/area/rogue/under/tomb/indoors)
"TE" = (
/obj/item/chair/stool/bar/rogue,
/turf/open/floor/rogue/ruinedwood/spiral,
/area/rogue/under/tomb/indoors)
"Ue" = (
/obj/item/soap/bath,
/turf/open/water/bath,
/area/rogue/under/tomb/indoors)
"Ug" = (
/obj/machinery/light/rogue/hearth,
/obj/item/cooking/pan,
/turf/open/floor/rogue/ruinedwood/spiral,
/area/rogue/under/tomb/indoors)
"UC" = (
/obj/machinery/light/rogue/torchholder/l,
/turf/open/floor/rogue/ruinedwood/spiral,
/area/rogue/under/tomb/indoors)
"Vf" = (
/turf/open/water/bath,
/area/rogue/under/tomb/indoors)
"VQ" = (
/obj/structure/fluff/walldeco/sign/trophy,
/turf/open/floor/rogue/ruinedwood/spiral,
/area/rogue/under/tomb/indoors)
"Wx" = (
/obj/structure/chair/bench/coucha/r,
/turf/open/floor/rogue/ruinedwood/spiral,
/area/rogue/under/tomb/indoors)
"WD" = (
/obj/structure/chair/bench/coucha,
/turf/open/floor/rogue/ruinedwood/spiral,
/area/rogue/under/tomb/indoors)
"Xl" = (
/obj/structure/fluff/walldeco/vinez/l,
/turf/open/floor/rogue/ruinedwood/spiral,
/area/rogue/under/tomb/indoors)
"Xn" = (
/obj/structure/fluff/walldeco/vinez,
/obj/structure/roguewindow,
/turf/open/floor/rogue/ruinedwood/spiral,
/area/rogue/under/tomb/indoors)
"Yh" = (
/obj/structure/fluff/railing/border{
	dir = 4
	},
/obj/structure/fluff/railing/border{
	dir = 4
	},
/turf/open/floor/rogue/ruinedwood/spiral,
/area/rogue/under/tomb/indoors)
"YI" = (
/obj/machinery/light/rogue/oven/west,
/turf/open/floor/rogue/ruinedwood/spiral,
/area/rogue/under/tomb/indoors)
"Zg" = (
/obj/item/reagent_containers/glass/cup/wooden/crafted{
	pixel_x = -6;
	pixel_y = 16
	},
/obj/item/reagent_containers/glass/cup/wooden/crafted{
	pixel_y = -8
	},
/obj/item/reagent_containers/glass/cup/wooden/crafted{
	pixel_x = 4;
	pixel_y = 14
	},
/obj/structure/table/wood{
	dir = 4;
	icon_state = "longtable"
	},
/turf/open/floor/rogue/ruinedwood/spiral,
/area/rogue/under/tomb/indoors)
"Zt" = (
/obj/machinery/light/rogue/chand,
/turf/open/transparent/openspace,
/area/rogue/under/tomb/indoors)
"Zv" = (
/obj/effect/dungeon_directional_helper/south,
/turf/open/floor/rogue/naturalstone,
/area/rogue/under/tomb)
"ZT" = (
/turf/closed/wall/mineral/rogue/stone/moss,
/area/rogue/under/tomb)

(1,1,1) = {"
tP
tP
tP
tP
tP
tP
tP
tP
tP
Ov
Qe
tP
tP
tP
tP
tP
tP
tP
tP
tP
"}
(2,1,1) = {"
tP
Qe
Qe
tu
tu
tu
tu
tu
tu
Qe
Qe
tu
tu
tu
tu
tu
tu
tu
tu
tP
"}
(3,1,1) = {"
tP
Qe
Qe
tu
tu
tu
tu
tu
ih
Qe
Qe
tu
ih
tu
tu
tu
Cb
tu
Qe
tP
"}
(4,1,1) = {"
tP
Qe
Qe
Im
Im
Im
Nd
Im
Im
nK
nK
Im
Im
Nd
Im
Im
Im
tu
Qe
tP
"}
(5,1,1) = {"
tP
tu
tu
Im
WD
ha
TE
lU
AX
lU
lU
lU
lU
lU
lU
lU
Im
tu
tu
tP
"}
(6,1,1) = {"
tP
Qe
tu
Im
Wx
FP
fO
lU
MK
vh
Ha
lU
LC
is
kl
lU
Im
tu
tu
tP
"}
(7,1,1) = {"
tP
Qe
tu
CW
lU
lU
qO
lU
AX
sC
lU
lU
lU
nW
ur
lU
sh
tu
Qe
tP
"}
(8,1,1) = {"
tP
tu
tu
Im
Oj
uh
Oj
lU
AX
VQ
lU
mI
lU
lU
gS
lU
sh
tu
tu
tP
"}
(9,1,1) = {"
tP
tu
tu
Im
lU
lU
lU
lU
lU
st
st
lU
lU
lU
lU
lU
Im
tu
Qe
tP
"}
(10,1,1) = {"
Qe
Qe
Qe
nK
st
lU
lU
lU
lU
st
lU
lU
lU
lU
lU
lU
nK
Qe
Qe
Qe
"}
(11,1,1) = {"
rI
Qe
Qe
nK
lU
lU
lU
lU
lU
lU
lU
fO
TE
fO
lU
lU
nK
Qe
Qe
Zv
"}
(12,1,1) = {"
tP
tu
Qe
Im
lU
lU
lU
Im
Im
SM
Im
Zg
BG
BG
SI
Du
Im
tu
tu
tP
"}
(13,1,1) = {"
tP
tu
tu
CW
lU
st
lU
Im
hi
lU
Im
ah
lU
lU
lU
OP
Im
tu
rA
tP
"}
(14,1,1) = {"
tP
Qe
tu
Im
Ly
Ly
lU
Im
hi
mI
Im
hm
lU
lU
lU
OP
sh
tu
tu
tP
"}
(15,1,1) = {"
tP
tu
tu
Im
Im
Im
lU
Im
Nc
lU
Im
jH
lU
lU
lU
lU
sh
tu
Qe
tP
"}
(16,1,1) = {"
tP
tu
tu
Im
Im
Im
It
Im
hi
lU
It
lU
YI
YI
Ug
oq
Im
tu
tu
tP
"}
(17,1,1) = {"
tP
tu
tu
Im
Im
Rh
lU
Im
Im
Im
Im
Im
Im
Im
Im
rK
Im
tu
tu
tP
"}
(18,1,1) = {"
tP
tu
tu
tu
ZT
ZT
ZT
ZT
tu
tu
tu
Qe
tu
tu
tu
tu
tu
tu
tu
tP
"}
(19,1,1) = {"
tP
tu
tu
tu
tu
tu
tu
tu
Qe
Qe
tu
tu
tu
Qe
tu
tu
Qe
tu
tu
tP
"}
(20,1,1) = {"
tP
tP
tP
tP
tP
tP
tP
tP
EK
Qe
tP
tP
tP
tP
tP
tP
tP
tP
tP
tP
"}

(1,1,2) = {"
tP
tP
tP
tP
tP
tP
tP
tP
tP
Ft
Ft
tP
tP
tP
tP
tP
tP
tP
tP
tP
"}
(2,1,2) = {"
tP
Ft
Ft
Ft
Ft
Ft
Ft
Ft
Ft
Ft
Ft
Ft
Ft
Ft
Ft
Ft
Ft
Ft
Ft
tP
"}
(3,1,2) = {"
tP
Ft
Ft
Fi
Fi
Fi
Fi
Fi
Fi
Fi
Fi
Fi
Fi
Fi
Fi
Fi
Fi
Ft
Ft
tP
"}
(4,1,2) = {"
tP
Ft
Fa
Im
Oj
Oj
gz
AX
Oj
gz
AX
Oj
Oj
AX
Oj
gz
Im
kA
Ft
tP
"}
(5,1,2) = {"
tP
Ft
Fa
AX
Fq
lU
lU
AX
Fq
Xl
AX
Fq
lU
AX
Fq
Xl
AX
kA
Ft
tP
"}
(6,1,2) = {"
tP
Ft
Fa
AX
Dx
hi
lU
AX
NF
lU
AX
NF
yH
AX
NF
lU
AX
kA
Ft
tP
"}
(7,1,2) = {"
tP
Ft
Fa
AX
Oj
Oj
It
AX
Oj
It
AX
Oj
It
AX
Oj
It
AX
kA
Ft
tP
"}
(8,1,2) = {"
tP
Ft
Fa
AX
lU
BZ
er
KB
KB
KB
KB
Yh
KB
uG
UC
lU
AX
kA
Ft
tP
"}
(9,1,2) = {"
tP
Ft
Fa
AX
lU
yH
Dk
yH
yH
yH
yH
yH
yH
tN
yH
lU
sd
kA
Ft
tP
"}
(10,1,2) = {"
Ft
Ft
Fa
sd
lU
lU
aB
yH
yc
yH
yH
Zt
yH
tN
lU
yH
Xn
kA
Ft
Ft
"}
(11,1,2) = {"
Ft
Ft
Fa
AX
nC
lU
yH
yH
yH
yH
yH
yH
yH
tN
lU
lU
AX
kA
Ft
Ft
"}
(12,1,2) = {"
tP
Ft
Fa
sd
yH
lU
eZ
ye
ye
ye
ye
ye
ye
oa
lU
lU
AX
kA
Ft
tP
"}
(13,1,2) = {"
tP
Ft
Fa
AX
KB
KB
uG
AX
Oj
Oj
It
AX
AX
AX
AX
AX
AX
kA
Ft
tP
"}
(14,1,2) = {"
tP
Ft
Fa
AX
yH
yH
tN
AX
Dx
lU
lU
AX
hi
lU
Bz
Vf
AX
kA
Ft
tP
"}
(15,1,2) = {"
tP
Ft
Fa
AX
Ly
Ly
tN
AX
lU
lU
lU
AX
lU
RA
Vf
Ue
bh
kA
Ft
tP
"}
(16,1,2) = {"
tP
Ft
Fa
AX
GU
tA
wR
AX
Fq
lU
lU
dU
lU
lU
Do
Vf
AX
kA
Ft
tP
"}
(17,1,2) = {"
tP
Ft
Fa
Im
Oj
Oj
Oj
Oj
Oj
gz
Oj
Oj
Oj
Oj
Oj
Oj
Im
kA
Ft
tP
"}
(18,1,2) = {"
tP
Ft
Ft
bp
bp
bp
bp
bp
bp
bp
bp
bp
bp
bp
bp
bp
bp
Ft
Ft
tP
"}
(19,1,2) = {"
tP
Ft
Ft
Ft
Ft
Ft
Ft
Ft
Ft
Ft
Ft
Ft
Ft
Ft
Ft
Ft
Ft
Ft
Ft
tP
"}
(20,1,2) = {"
tP
tP
tP
tP
tP
tP
tP
tP
Ft
Ft
tP
tP
tP
tP
tP
tP
tP
tP
tP
tP
"}
