//MAP CONVERTED BY dmm2tgm.py THIS HEADER COMMENT PREVENTS RECONVERSION, DO NOT REMOVE
"ae" = (
/turf/closed/mineral/rogue/bedrock,
/area/rogue/under/tomb/cave)
"ao" = (
/obj/structure/chair/stool/rogue,
/obj/item/fishingrod,
/obj/item/natural/worms,
/turf/open/floor/rogue/ruinedwood,
/area/rogue/under/tomb/cave)
"aN" = (
/mob/living/carbon/human/species/goblin/npc/cave,
/turf/open/floor/rogue/dirt,
/area/rogue/under/tomb/wilds)
"bZ" = (
/obj/structure/stairs/stone{
	dir = 4
	},
/turf/open/floor/rogue/snow,
/area/rogue/under/tomb/wilds)
"cD" = (
/obj/machinery/light/rogue/firebowl,
/turf/open/floor/rogue/snow,
/area/rogue/under/tomb/wilds)
"cG" = (
/obj/structure/fluff/railing/border,
/turf/open/floor/rogue/metal,
/area/rogue/under/tomb/cave)
"cJ" = (
/obj/structure/fluff/railing/wood{
	dir = 1
	},
/obj/structure/fluff/railing/wood{
	dir = 8
	},
/turf/open/floor/rogue/dirt,
/area/rogue/under/tomb/wilds)
"dh" = (
/turf/open/floor/rogue/dirt,
/area/rogue/under/tomb/cave)
"eU" = (
/obj/effect/decal/cleanable/blood/drip,
/obj/item/rogueweapon/spear/billhook,
/obj/item/clothing/head/roguetown/circlet,
/obj/effect/spawner/lootdrop/roguetown/dungeon/money,
/obj/effect/spawner/lootdrop/potion_vitals,
/obj/effect/mapping_helpers/floor_clothing_equipper,
/mob/living/carbon/human/species/goblin/npc{
	STACON = 20;
	STAWIL = 20;
	STAINT = 20;
	STALUC = 20;
	STAPER = 20;
	STASPD = 20;
	name = "Level 1 Goblin"
	},
/turf/open/floor/rogue/dirt,
/area/rogue/under/tomb/wilds)
"ff" = (
/obj/structure/flora/roguegrass/water/reeds,
/turf/open/water,
/area/rogue/under/tomb/cave)
"fu" = (
/turf/open/water/river,
/area/rogue/under/tomb/cave)
"hy" = (
/turf/open/floor/rogue/grasscold,
/area/rogue/under/tomb/cave)
"ii" = (
/turf/open/floor/rogue/ruinedwood/turned,
/area/rogue/under/tomb/cave)
"iN" = (
/obj/structure/mineral_door/bars,
/turf/open/floor/rogue/dirt,
/area/rogue/under/tomb/cave)
"jO" = (
/mob/living/carbon/human/species/orc/npc/marauder,
/turf/open/floor/rogue/snowpatchy,
/area/rogue/under/tomb/wilds)
"kc" = (
/obj/structure/fermentation_keg/random/water,
/turf/open/floor/rogue/grasscold,
/area/rogue/under/tomb/wilds)
"kd" = (
/obj/structure/table/wood,
/obj/item/reagent_containers/glass/bottle/claybottle/wine,
/turf/open/floor/rogue/grasscold,
/area/rogue/under/tomb/wilds)
"kK" = (
/obj/machinery/light/rogue/hearth,
/obj/machinery/light/rogue/oven/east,
/obj/item/cooking/pan,
/turf/open/floor/rogue/dirt,
/area/rogue/under/tomb/wilds)
"lZ" = (
/mob/living/carbon/human/species/goblin/npc/cave,
/turf/open/floor/rogue/dirt,
/area/rogue/under/tomb/cave)
"ml" = (
/obj/item/bait/bloody,
/obj/item/bait/bloody,
/obj/item/bait/bloody,
/obj/item/bait/bloody,
/obj/item/bait/bloody,
/obj/item/bait/bloody,
/obj/item/bait/bloody,
/turf/open/floor/rogue/ruinedwood,
/area/rogue/under/tomb/cave)
"mQ" = (
/turf/open/floor/rogue/dirt,
/area/rogue/under/tomb/wilds)
"mU" = (
/turf/open/floor/rogue/snow,
/area/rogue/under/tomb/cave)
"nG" = (
/obj/structure/chair/stool/rogue,
/turf/open/floor/rogue/grasscold,
/area/rogue/under/tomb/wilds)
"on" = (
/turf/open/floor/rogue/snowpatchy,
/area/rogue/under/tomb/wilds)
"op" = (
/obj/structure/flora/roguetree/stump/pine,
/turf/open/floor/rogue/grasscold,
/area/rogue/under/tomb/wilds)
"oH" = (
/turf/open/water,
/area/rogue/under/tomb/cave)
"pe" = (
/turf/open/floor/rogue/dirt,
/area/rogue/under/tomb/indoors)
"pt" = (
/obj/structure/fluff/railing/border{
	dir = 1
	},
/turf/open/floor/rogue/metal,
/area/rogue/under/tomb/cave)
"pB" = (
/obj/structure/flora/roguetree/stump,
/turf/open/floor/rogue/snow,
/area/rogue/under/tomb/wilds)
"qh" = (
/obj/structure/barricade,
/turf/open/floor/rogue/dirt,
/area/rogue/under/tomb/cave)
"rD" = (
/turf/open/transparent/openspace,
/area/rogue/under/tomb/wilds)
"rS" = (
/obj/structure/fluff/railing/wood,
/obj/structure/fluff/railing/wood{
	dir = 4
	},
/turf/open/floor/rogue/snow,
/area/rogue/under/tomb/wilds)
"sG" = (
/turf/open/water/river{
	dir = 8
	},
/area/rogue/under/tomb/cave)
"vX" = (
/obj/structure/closet/crate/chest/crate,
/obj/item/reagent_containers/glass/bottle/waterskin,
/obj/item/reagent_containers/food/snacks/rogue/cheese,
/obj/item/reagent_containers/food/snacks/rogue/cheese,
/obj/item/reagent_containers/food/snacks/rogue/cheese,
/obj/item/reagent_containers/food/snacks/rogue/cheese,
/turf/open/floor/rogue/dirt,
/area/rogue/under/tomb/wilds)
"wL" = (
/obj/machinery/light/rogue/firebowl,
/turf/open/floor/rogue/dirt,
/area/rogue/under/tomb/cave)
"wP" = (
/obj/structure/table/wood,
/turf/open/floor/rogue/grasscold,
/area/rogue/under/tomb/wilds)
"yw" = (
/obj/structure/table/wood,
/obj/item/reagent_containers/food/snacks/rogue/meat/salami,
/turf/open/floor/rogue/dirt,
/area/rogue/under/tomb/wilds)
"yB" = (
/obj/effect/spawner/lootdrop/roguetown/dungeon/spells,
/turf/open/floor/rogue/dirt,
/area/rogue/under/tomb/wilds)
"yN" = (
/obj/structure/fluff/railing/wood{
	dir = 1
	},
/obj/structure/fluff/railing/wood{
	dir = 4
	},
/turf/open/floor/rogue/grasscold,
/area/rogue/under/tomb/wilds)
"zc" = (
/obj/structure/mineral_door/bars,
/obj/effect/dungeon_directional_helper/east,
/turf/open/floor/rogue/dirt,
/area/rogue/under/tomb/cave)
"zp" = (
/obj/structure/flora/roguetree/stump,
/turf/open/floor/rogue/grasscold,
/area/rogue/under/tomb/wilds)
"zM" = (
/obj/effect/spawner/lootdrop/potion_vitals,
/turf/open/floor/rogue/grasscold,
/area/rogue/under/tomb/wilds)
"zZ" = (
/obj/machinery/light/rogue/hearth,
/obj/machinery/light/rogue/oven/east,
/turf/open/floor/rogue/dirt,
/area/rogue/under/tomb/wilds)
"Ad" = (
/obj/structure/fluff/railing/wood,
/obj/structure/fluff/railing/wood{
	dir = 4
	},
/turf/open/floor/rogue/snowpatchy,
/area/rogue/under/tomb/wilds)
"Ax" = (
/obj/structure/fluff/railing/border,
/turf/open/floor/rogue/metal,
/area/rogue/under/tomb/wilds)
"AA" = (
/obj/structure/bed/rogue/shit,
/mob/living/carbon/human/species/goblin/npc/cave,
/turf/open/floor/rogue/dirt,
/area/rogue/under/tomb/indoors)
"AK" = (
/obj/structure/fermentation_keg/random/beer,
/obj/item/reagent_containers/glass/cup/golden,
/turf/open/floor/rogue/dirt,
/area/rogue/under/tomb/cave)
"AR" = (
/obj/machinery/light/rogue/campfire,
/obj/item/reagent_containers/food/snacks/rogue/meat/salami,
/turf/open/floor/rogue/grasscold,
/area/rogue/under/tomb/wilds)
"Cd" = (
/obj/machinery/light/rogue/firebowl,
/turf/open/floor/rogue/snowpatchy,
/area/rogue/under/tomb/wilds)
"Ct" = (
/obj/structure/mineral_door/bars,
/obj/effect/dungeon_directional_helper/south,
/turf/open/floor/rogue/dirt,
/area/rogue/under/tomb/cave)
"Cz" = (
/obj/structure/table/wood,
/obj/item/reagent_containers/glass/bottle/rogue/redwine,
/turf/open/floor/rogue/grasscold,
/area/rogue/under/tomb/wilds)
"CE" = (
/obj/machinery/light/rogue/firebowl,
/turf/open/floor/rogue/grasscold,
/area/rogue/under/tomb/cave)
"CK" = (
/obj/structure/closet/crate/chest/wicker,
/obj/item/flashlight/flare/torch/lantern/bronzelamptern,
/obj/item/flashlight/flare/torch/lantern/bronzelamptern,
/obj/machinery/light/rogue/candle,
/turf/open/floor/rogue/dirt,
/area/rogue/under/tomb/indoors)
"CQ" = (
/obj/structure/stairs/stone{
	dir = 1
	},
/turf/open/floor/rogue/snow,
/area/rogue/under/tomb/wilds)
"CS" = (
/obj/structure/fluff/railing/wood,
/turf/open/floor/rogue/snow,
/area/rogue/under/tomb/wilds)
"EL" = (
/obj/effect/decal/cleanable/blood/drip,
/turf/open/floor/rogue/dirt,
/area/rogue/under/tomb/wilds)
"Fe" = (
/obj/structure/fluff/railing/wood,
/turf/open/floor/rogue/grasscold,
/area/rogue/under/tomb/wilds)
"FU" = (
/obj/structure/fluff/railing/wood{
	dir = 4
	},
/turf/open/floor/rogue/dirt,
/area/rogue/under/tomb/wilds)
"HA" = (
/obj/structure/mineral_door/bars,
/obj/effect/dungeon_directional_helper/north,
/turf/open/floor/rogue/dirt,
/area/rogue/under/tomb/cave)
"Ib" = (
/obj/effect/spawner/lootdrop/general_loot_hi,
/turf/open/floor/rogue/grasscold,
/area/rogue/under/tomb/wilds)
"IS" = (
/obj/machinery/light/rogue/firebowl,
/turf/open/floor/rogue/dirt,
/area/rogue/under/tomb/wilds)
"JS" = (
/obj/effect/decal/cleanable/blood,
/turf/open/floor/rogue/dirt,
/area/rogue/under/tomb/wilds)
"Kr" = (
/turf/closed/wall/mineral/rogue/tent,
/area/rogue/under/tomb/indoors)
"KC" = (
/obj/structure/flora/roguetree/stump/pine,
/turf/open/floor/rogue/snow,
/area/rogue/under/tomb/wilds)
"KV" = (
/obj/structure/flora/roguetree/stump/pine,
/turf/open/floor/rogue/grasscold,
/area/rogue/under/tomb/cave)
"LB" = (
/obj/structure/roguetent,
/turf/open/floor/rogue/dirt,
/area/rogue/under/tomb/indoors)
"Md" = (
/obj/structure/fluff/railing/border{
	dir = 1
	},
/turf/open/floor/rogue/metal,
/area/rogue/under/tomb/wilds)
"My" = (
/obj/structure/fluff/railing/wood{
	dir = 8
	},
/turf/open/floor/rogue/dirt,
/area/rogue/under/tomb/wilds)
"MJ" = (
/obj/structure/fluff/railing/wood{
	dir = 1
	},
/turf/open/floor/rogue/grasscold,
/area/rogue/under/tomb/wilds)
"MQ" = (
/obj/structure/fluff/railing/wood{
	dir = 8
	},
/obj/structure/fluff/railing/wood,
/turf/open/floor/rogue/dirt,
/area/rogue/under/tomb/wilds)
"Ne" = (
/mob/living/carbon/human/species/orc/npc/footsoldier,
/turf/open/floor/rogue/snowpatchy,
/area/rogue/under/tomb/wilds)
"Op" = (
/obj/effect/spawner/lootdrop/general_loot_hi,
/turf/open/floor/rogue/dirt,
/area/rogue/under/tomb/wilds)
"Pa" = (
/obj/structure/fluff/railing/wood,
/turf/open/floor/rogue/snowpatchy,
/area/rogue/under/tomb/wilds)
"Pu" = (
/obj/structure/bed/rogue/shit,
/turf/open/floor/rogue/dirt,
/area/rogue/under/tomb/indoors)
"QS" = (
/obj/structure/table/wood,
/obj/item/millstone,
/obj/item/rogueweapon/huntingknife/idagger,
/turf/open/floor/rogue/dirt,
/area/rogue/under/tomb/wilds)
"Rc" = (
/mob/living/carbon/human/species/goblin/npc/cave,
/turf/open/floor/rogue/grasscold,
/area/rogue/under/tomb/wilds)
"RK" = (
/obj/effect/spawner/lootdrop/roguetown/dungeon/weapons,
/turf/open/floor/rogue/grasscold,
/area/rogue/under/tomb/wilds)
"Sc" = (
/obj/structure/fermentation_keg/random/beer,
/turf/open/floor/rogue/grasscold,
/area/rogue/under/tomb/wilds)
"Ss" = (
/obj/structure/fluff/statue/tdummy,
/turf/open/floor/rogue/dirt,
/area/rogue/under/tomb/wilds)
"SZ" = (
/obj/structure/fluff/statue/tdummy,
/turf/open/floor/rogue/grasscold,
/area/rogue/under/tomb/wilds)
"UV" = (
/obj/structure/fluff/railing/wood{
	dir = 4
	},
/turf/open/floor/rogue/snow,
/area/rogue/under/tomb/wilds)
"UY" = (
/turf/open/floor/rogue/snow,
/area/rogue/under/tomb/wilds)
"VO" = (
/obj/effect/dungeon_directional_helper/west,
/turf/open/floor/rogue/dirt,
/area/rogue/under/tomb/cave)
"WR" = (
/turf/open/floor/rogue/ruinedwood,
/area/rogue/under/tomb/cave)
"Xg" = (
/obj/structure/fluff/railing/wood{
	dir = 4
	},
/turf/open/floor/rogue/grasscold,
/area/rogue/under/tomb/wilds)
"XD" = (
/turf/closed/mineral/rogue/bedrock,
/area/rogue/under/tomb/wilds)
"XN" = (
/turf/open/water/river{
	dir = 4
	},
/area/rogue/under/tomb/cave)
"Yd" = (
/obj/structure/closet/crate/chest/wicker,
/obj/machinery/light/rogue/candle,
/obj/effect/spawner/lootdrop/random_gem,
/turf/open/floor/rogue/dirt,
/area/rogue/under/tomb/indoors)
"Ys" = (
/obj/structure/fluff/railing/wood{
	dir = 4
	},
/obj/structure/fluff/railing/wood,
/turf/open/floor/rogue/grasscold,
/area/rogue/under/tomb/wilds)
"YE" = (
/turf/open/floor/rogue/ruinedwood/turned,
/area/rogue/under/tomb/wilds)
"Zo" = (
/turf/open/floor/rogue/grasscold,
/area/rogue/under/tomb/wilds)

(1,1,1) = {"
ae
ae
ae
ae
ae
ae
ae
ae
ae
ae
ae
ae
ae
dh
VO
dh
ae
ae
ae
ae
ae
ae
ae
ae
ae
ae
ae
ae
ae
ae
"}
(2,1,1) = {"
ae
XN
oH
oH
oH
ae
ae
XD
mQ
mQ
mQ
mQ
mQ
mQ
mQ
mQ
mQ
mQ
mQ
XD
CQ
UY
UY
UY
UY
oH
oH
fu
fu
ae
"}
(3,1,1) = {"
ae
fu
fu
XN
oH
oH
oH
XD
XD
mQ
mQ
IS
mQ
Zo
Zo
Zo
Zo
XD
XD
XD
CQ
UY
UY
UY
ff
oH
oH
sG
ff
ae
"}
(4,1,1) = {"
ae
oH
oH
XN
ff
oH
oH
UY
XD
XD
Zo
Zo
Zo
UY
UY
XD
XD
XD
UY
UY
UY
UY
UY
oH
oH
ff
fu
sG
oH
ae
"}
(5,1,1) = {"
ae
oH
ff
XN
oH
oH
UY
UY
UY
XD
XD
XD
UY
UY
XD
XD
UY
UY
UY
UY
UY
UY
UY
oH
fu
fu
sG
oH
oH
ae
"}
(6,1,1) = {"
ae
oH
oH
XN
oH
oH
oH
oH
UY
UY
UY
UY
UY
UY
UY
UY
UY
UY
UY
UY
oH
oH
ff
oH
sG
oH
oH
oH
ae
ae
"}
(7,1,1) = {"
ae
ae
oH
fu
fu
fu
XN
oH
ff
oH
oH
UY
Md
YE
Ax
UY
oH
oH
oH
oH
oH
fu
fu
fu
sG
ff
oH
mQ
mQ
ae
"}
(8,1,1) = {"
ae
ae
ae
oH
oH
oH
fu
fu
fu
XN
oH
oH
pt
ii
cG
oH
ff
fu
fu
fu
fu
sG
oH
oH
oH
oH
XD
XD
mQ
ae
"}
(9,1,1) = {"
ae
AK
ae
UY
UY
oH
oH
oH
oH
fu
fu
fu
pt
ii
cG
fu
fu
sG
oH
oH
ff
oH
oH
UY
Zo
Zo
XD
mQ
mQ
ae
"}
(10,1,1) = {"
ae
lZ
ae
UY
Zo
Zo
Zo
oH
oH
oH
oH
ff
pt
ii
cG
oH
oH
oH
oH
UY
UY
Zo
Zo
Zo
Zo
Zo
XD
mQ
Zo
ae
"}
(11,1,1) = {"
ae
qh
ae
Zo
on
on
Zo
Zo
Zo
UY
UY
UY
Md
YE
Ax
UY
UY
UY
UY
Zo
Zo
Zo
on
on
on
Zo
XD
Zo
Zo
ae
"}
(12,1,1) = {"
ae
qh
ae
Zo
on
on
on
on
on
Zo
UY
UY
UY
UY
UY
UY
UY
UY
Zo
Zo
Zo
Ne
on
Cd
on
Zo
XD
Zo
Zo
ae
"}
(13,1,1) = {"
ae
dh
ae
ae
Zo
on
Cd
jO
on
Zo
UY
UY
UY
UY
UY
UY
UY
UY
UY
Zo
on
on
on
on
Zo
Zo
XD
Zo
Zo
ae
"}
(14,1,1) = {"
HA
dh
wL
ae
Zo
on
on
on
Zo
UY
UY
UY
bZ
bZ
bZ
UY
UY
UY
UY
Zo
on
on
Zo
Zo
Zo
XD
XD
Zo
mQ
Ct
"}
(15,1,1) = {"
ae
dh
dh
ae
ae
Zo
Zo
Zo
UY
UY
XD
XD
XD
XD
XD
XD
XD
XD
UY
UY
UY
UY
UY
Zo
XD
XD
IS
mQ
mQ
ae
"}
(16,1,1) = {"
iN
dh
dh
dh
ae
ae
UY
UY
UY
XD
XD
QS
yw
kK
zZ
vX
vX
XD
XD
XD
UY
UY
XD
XD
XD
mQ
mQ
mQ
mQ
iN
"}
(17,1,1) = {"
ae
dh
dh
dh
dh
mU
UY
UY
UY
UY
mQ
mQ
mQ
mQ
Zo
Zo
Zo
mQ
UY
UY
UY
UY
UY
UY
mQ
mQ
mQ
aN
mQ
ae
"}
(18,1,1) = {"
ae
dh
dh
Kr
Kr
Kr
Kr
UY
UY
mQ
mQ
mQ
Zo
Zo
Zo
Zo
Zo
Zo
mQ
mQ
UY
UY
UY
mQ
mQ
mQ
WR
WR
WR
ae
"}
(19,1,1) = {"
ae
dh
dh
Kr
Pu
pe
Kr
Kr
mQ
IS
mQ
kc
wP
Zo
Rc
wP
Sc
Zo
mQ
mQ
mQ
IS
mQ
mQ
mQ
mQ
WR
WR
WR
ae
"}
(20,1,1) = {"
ae
dh
dh
Kr
CK
pe
pe
LB
mQ
mQ
Zo
wP
kd
wP
wP
Cz
wP
Zo
mQ
mQ
mQ
mQ
mQ
mQ
mQ
oH
WR
WR
ml
ae
"}
(21,1,1) = {"
ae
dh
dh
Kr
AA
pe
Kr
Kr
mQ
mQ
Zo
Zo
nG
nG
nG
nG
mQ
mQ
mQ
mQ
Ss
mQ
mQ
ff
oH
oH
WR
ao
WR
ae
"}
(22,1,1) = {"
ae
dh
dh
Kr
Kr
Kr
Kr
mQ
mQ
mQ
mQ
mQ
mQ
mQ
mQ
mQ
mQ
mQ
mQ
Zo
Zo
Zo
oH
oH
oH
oH
oH
oH
oH
ae
"}
(23,1,1) = {"
ae
dh
dh
dh
dh
dh
dh
mQ
mQ
mQ
cJ
My
My
My
My
My
My
MQ
Zo
SZ
Zo
oH
oH
oH
oH
oH
oH
oH
oH
ae
"}
(24,1,1) = {"
ae
dh
Kr
Kr
Kr
Kr
dh
mQ
mQ
Zo
MJ
RK
mQ
JS
mQ
EL
yB
Fe
Zo
Zo
Zo
oH
oH
oH
ff
dh
hy
hy
oH
ae
"}
(25,1,1) = {"
ae
dh
Kr
Pu
pe
Kr
Kr
mQ
Zo
Zo
MJ
Ib
mQ
mQ
eU
mQ
Zo
Fe
Zo
Zo
ff
oH
oH
oH
hy
hy
CE
hy
oH
ae
"}
(26,1,1) = {"
ae
dh
Kr
Yd
pe
pe
LB
mQ
Zo
Zo
MJ
Zo
mQ
Op
mQ
zM
Zo
Fe
Zo
mQ
oH
oH
oH
hy
hy
KV
hy
hy
oH
ae
"}
(27,1,1) = {"
ae
dh
Kr
Pu
pe
Kr
Kr
mQ
Zo
Zo
yN
FU
FU
FU
Xg
Xg
Xg
Ys
mQ
mQ
oH
oH
ff
hy
hy
hy
dh
oH
oH
ae
"}
(28,1,1) = {"
ae
dh
Kr
Kr
Kr
Kr
dh
mQ
IS
mQ
mQ
mQ
mQ
mQ
Zo
Zo
mQ
mQ
mQ
IS
oH
oH
oH
oH
dh
dh
oH
ff
oH
ae
"}
(29,1,1) = {"
ae
dh
dh
dh
dh
dh
dh
mQ
mQ
mQ
mQ
mQ
mQ
mQ
mQ
mQ
mQ
mQ
mQ
oH
oH
oH
oH
oH
oH
oH
oH
oH
oH
ae
"}
(30,1,1) = {"
ae
ae
ae
ae
ae
ae
ae
ae
ae
ae
ae
ae
ae
ae
zc
ae
iN
ae
ae
ae
ae
ae
ae
ae
ae
ae
ae
ae
ae
ae
"}

(1,1,2) = {"
XD
XD
XD
XD
XD
XD
XD
XD
XD
XD
XD
XD
XD
UY
on
UY
UY
XD
XD
XD
XD
XD
XD
XD
XD
XD
XD
XD
XD
XD
"}
(2,1,2) = {"
XD
rD
rD
rD
rD
UY
UY
UY
UY
UY
UY
on
on
Zo
Zo
on
UY
UY
UY
CQ
rD
rD
rD
rD
rD
rD
rD
rD
rD
XD
"}
(3,1,2) = {"
XD
rD
rD
rD
rD
rD
rD
UY
UY
UY
Zo
Zo
Zo
Zo
Zo
Zo
on
UY
UY
CQ
rD
rD
rD
rD
rD
rD
rD
rD
rD
XD
"}
(4,1,2) = {"
XD
rD
rD
rD
rD
rD
rD
rD
UY
UY
on
nG
AR
nG
Zo
on
on
UY
rD
rD
rD
rD
rD
rD
rD
rD
rD
rD
rD
XD
"}
(5,1,2) = {"
XD
rD
rD
rD
rD
rD
rD
rD
rD
UY
on
Zo
Zo
Zo
Zo
on
rD
rD
rD
rD
rD
rD
rD
rD
rD
rD
rD
rD
rD
XD
"}
(6,1,2) = {"
XD
rD
rD
rD
rD
rD
rD
rD
rD
rD
rD
rD
rD
rD
rD
rD
rD
rD
rD
rD
rD
rD
rD
rD
rD
rD
rD
rD
KC
XD
"}
(7,1,2) = {"
XD
UY
rD
rD
rD
rD
rD
rD
rD
rD
rD
rD
rD
rD
rD
rD
rD
rD
rD
rD
rD
rD
rD
rD
rD
rD
rD
UY
UY
XD
"}
(8,1,2) = {"
XD
UY
UY
rD
rD
rD
rD
rD
rD
rD
rD
rD
rD
rD
rD
rD
rD
rD
rD
rD
rD
rD
rD
rD
rD
rD
UY
UY
UY
XD
"}
(9,1,2) = {"
XD
UY
UY
rD
rD
rD
rD
rD
rD
rD
rD
rD
rD
rD
rD
rD
rD
rD
rD
rD
rD
rD
rD
rD
rD
rD
UY
cD
UY
XD
"}
(10,1,2) = {"
XD
KC
UY
rD
rD
rD
rD
rD
rD
rD
rD
rD
rD
rD
rD
rD
rD
rD
rD
rD
rD
rD
rD
rD
rD
rD
UY
UY
UY
XD
"}
(11,1,2) = {"
XD
UY
UY
rD
rD
rD
rD
rD
rD
rD
rD
rD
rD
rD
rD
rD
rD
rD
rD
rD
rD
rD
rD
rD
rD
rD
UY
UY
UY
XD
"}
(12,1,2) = {"
XD
UY
UY
rD
rD
rD
rD
rD
rD
rD
rD
rD
rD
rD
rD
rD
rD
rD
rD
rD
rD
rD
rD
rD
rD
rD
UY
UY
UY
XD
"}
(13,1,2) = {"
XD
UY
UY
KC
rD
rD
rD
rD
rD
rD
rD
rD
rD
rD
rD
rD
rD
rD
rD
rD
rD
rD
rD
rD
rD
rD
UY
UY
UY
XD
"}
(14,1,2) = {"
on
on
UY
UY
rD
rD
rD
rD
rD
rD
rD
rD
rD
rD
rD
rD
rD
rD
rD
rD
rD
rD
rD
rD
rD
UY
UY
UY
UY
UY
"}
(15,1,2) = {"
on
on
on
UY
UY
rD
rD
rD
rD
rD
UY
UY
bZ
bZ
bZ
Zo
Zo
UY
rD
rD
rD
rD
rD
rD
UY
UY
UY
UY
UY
UY
"}
(16,1,2) = {"
UY
on
on
UY
UY
UY
UY
UY
UY
UY
UY
UY
Zo
on
on
Zo
UY
UY
UY
UY
UY
UY
UY
UY
UY
UY
UY
UY
UY
UY
"}
(17,1,2) = {"
XD
on
on
Zo
Zo
UY
UY
UY
Zo
Zo
Zo
Zo
Zo
on
on
Zo
UY
UY
UY
on
on
UY
UY
UY
UY
UY
UY
UV
UV
XD
"}
(18,1,2) = {"
XD
on
on
on
on
Zo
Zo
Zo
Zo
zp
Zo
Zo
on
on
on
Zo
Zo
UY
on
on
on
UY
UY
UY
UY
UV
rS
rD
rD
XD
"}
(19,1,2) = {"
XD
UY
on
on
on
on
Zo
Zo
Zo
Zo
Zo
Zo
on
on
Zo
Zo
Zo
UY
on
on
pB
UY
UY
cD
rS
rD
rD
rD
rD
XD
"}
(20,1,2) = {"
XD
UY
UY
Zo
on
on
on
on
Zo
Zo
Zo
on
on
Zo
Zo
zp
Zo
UY
UY
UY
UY
UY
UV
rS
rD
rD
rD
rD
rD
XD
"}
(21,1,2) = {"
XD
UY
UY
Zo
Zo
on
on
on
on
on
Zo
on
on
Zo
Zo
Zo
Zo
UY
UY
UY
UV
rS
rD
rD
rD
rD
rD
rD
rD
XD
"}
(22,1,2) = {"
XD
UY
UY
Zo
Zo
Zo
Zo
on
on
on
on
on
on
Zo
Zo
Zo
Zo
UY
UY
rS
rD
rD
rD
rD
rD
rD
rD
rD
rD
XD
"}
(23,1,2) = {"
XD
UY
UY
Zo
zp
Zo
Zo
Zo
Zo
on
on
on
Zo
op
Zo
Zo
on
on
CS
rD
rD
rD
rD
rD
rD
rD
rD
rD
rD
XD
"}
(24,1,2) = {"
XD
UY
UY
UY
Zo
Zo
Zo
zp
Zo
Zo
on
on
Zo
Zo
Zo
Zo
on
Cd
Pa
rD
rD
rD
rD
rD
rD
rD
rD
rD
rD
XD
"}
(25,1,2) = {"
XD
UY
UY
UY
on
on
Zo
Zo
Zo
Zo
on
on
Zo
Zo
Zo
Zo
UY
on
Ad
rD
rD
rD
rD
rD
rD
rD
rD
rD
rD
XD
"}
(26,1,2) = {"
XD
UY
UY
on
on
on
Zo
Zo
Zo
Zo
on
on
Zo
zp
Zo
Zo
UY
CS
rD
rD
rD
rD
rD
rD
rD
rD
rD
rD
rD
XD
"}
(27,1,2) = {"
XD
UY
UY
on
on
UY
UY
UY
Zo
Zo
on
on
Zo
Zo
Zo
UY
UY
CS
rD
rD
rD
rD
rD
rD
rD
rD
rD
rD
rD
XD
"}
(28,1,2) = {"
XD
XD
UY
UY
UY
UY
UY
UY
UY
UY
on
on
on
on
on
on
UY
CS
rD
rD
rD
rD
rD
rD
rD
rD
rD
rD
rD
XD
"}
(29,1,2) = {"
XD
XD
XD
UY
UY
UY
UY
UY
UY
UY
UY
on
on
on
on
on
on
CS
rD
rD
rD
rD
rD
rD
rD
rD
rD
rD
rD
XD
"}
(30,1,2) = {"
XD
XD
XD
XD
XD
XD
XD
XD
XD
XD
XD
XD
XD
XD
UY
on
on
XD
XD
XD
XD
XD
XD
XD
XD
XD
XD
XD
XD
XD
"}
