//MAP CONVERTED BY dmm2tgm.py THIS HEADER COMMENT PREVENTS RECONVERSION, DO NOT REMOVE
"au" = (
/obj/structure/table/wood,
/obj/item/pestle,
/obj/effect/decal/cleanable/dirt/dust,
/obj/effect/spawner/lootdrop/general_loot_low/x3,
/turf/open/floor/rogue/cobble,
/area/rogue/under/tomb/indoors/rest)
"aC" = (
/obj/effect/decal/cleanable/dirt/dust,
/obj/structure/table/wood,
/obj/effect/spawner/lootdrop/general_loot_low,
/turf/open/floor/rogue/wood,
/area/rogue/under/tomb/indoors/rest)
"aS" = (
/obj/machinery/light/rogue/candle/weak/l,
/obj/structure/mannequin/male/female,
/turf/open/floor/rogue/herringbone,
/area/rogue/under/tomb/indoors)
"bm" = (
/obj/effect/decal/cleanable/dirt/dust,
/turf/open/floor/rogue/wood,
/area/rogue/under/tomb/indoors/rest)
"bT" = (
/turf/open/floor/rogue/cobblerock,
/area/rogue/under/tomb)
"bY" = (
/obj/effect/decal/remains/human,
/obj/item/reagent_containers/glass/bottle{
	pixel_x = -6;
	pixel_y = -6;
	closed = 0
	},
/turf/open/floor/carpet/royalblack,
/area/rogue/under/tomb/indoors/rest)
"cB" = (
/obj/effect/decal/cleanable/dirt/dust,
/turf/open/floor/rogue/blocks/green,
/area/rogue/under/tomb/indoors/rest)
"cI" = (
/turf/open/water/swamp,
/area/rogue/under/tomb)
"di" = (
/obj/structure/mineral_door/wood/deadbolt{
	dir = 1
	},
/turf/open/floor/rogue/blocks,
/area/rogue/under/tomb/indoors/rest)
"fg" = (
/obj/effect/decal/cobbleedge,
/turf/open/floor/rogue/naturalstone,
/area/rogue/under/tomb)
"fv" = (
/turf/closed/wall/mineral/rogue/stone,
/area/rogue/under/tomb/indoors/rest)
"fx" = (
/obj/effect/decal/cobbleedge{
	dir = 10
	},
/turf/open/floor/rogue/naturalstone,
/area/rogue/under/tomb)
"gb" = (
/obj/machinery/light/rogue/torchholder/l,
/obj/effect/decal/cleanable/dirt/dust,
/obj/effect/decal/cleanable/dirt/dust,
/turf/open/floor/rogue/blocks,
/area/rogue/under/tomb/indoors/rest)
"gs" = (
/obj/structure/fermentation_keg/random/water,
/turf/open/floor/rogue/blocks,
/area/rogue/under/tomb/indoors/rest)
"gP" = (
/obj/structure/flora/roguetree/stump,
/turf/open/floor/rogue/dirt,
/area/rogue/under/tomb)
"hz" = (
/obj/effect/decal/cleanable/dirt/dust,
/obj/machinery/light/rogue/candle/r,
/turf/open/floor/rogue/wood,
/area/rogue/under/tomb/indoors/rest)
"ic" = (
/obj/machinery/light/rogue/cauldron,
/obj/effect/decal/cleanable/dirt/dust,
/turf/open/floor/rogue/blocks/green,
/area/rogue/under/tomb/indoors/rest)
"id" = (
/obj/effect/decal/shadow_floor{
	dir = 4
	},
/obj/structure/fluff/railing/border{
	dir = 4
	},
/turf/open/floor/rogue/cobble,
/area/rogue/under/tomb/indoors/rest)
"js" = (
/turf/closed/wall/mineral/rogue/decostone/cand,
/area/rogue/under/tomb/indoors)
"jI" = (
/obj/machinery/light/rogue/torchholder/l,
/obj/effect/decal/cleanable/dirt/dust,
/turf/open/floor/rogue/cobble,
/area/rogue/under/tomb/indoors/rest)
"ke" = (
/obj/structure/fluff/walldeco/painting/skull{
	pixel_x = -32
	},
/obj/effect/decal/cleanable/dirt/dust,
/turf/open/floor/rogue/wood,
/area/rogue/under/tomb/indoors/rest)
"lA" = (
/turf/open/floor/rogue/dirt/road,
/area/rogue/under/tomb)
"nX" = (
/obj/structure/fluff/railing/border{
	dir = 4
	},
/turf/open/floor/rogue/wood,
/area/rogue/under/tomb/indoors/rest)
"ok" = (
/obj/structure/mineral_door/wood/red,
/turf/open/floor/rogue/wood/nosmooth,
/area/rogue/under/tomb/indoors/rest)
"oZ" = (
/turf/closed/mineral/rogue/bedrock,
/area/rogue/under/tomb)
"pK" = (
/turf/open/transparent/openspace,
/area/rogue/under/tomb/indoors/rest)
"qe" = (
/turf/open/floor/rogue/herringbone,
/area/rogue/under/tomb/indoors)
"qm" = (
/obj/structure/stairs/stone,
/turf/open/floor/rogue/cobble,
/area/rogue/under/tomb/indoors/rest)
"qz" = (
/turf/open/floor/carpet/purple,
/area/rogue/under/tomb/indoors/rest)
"qV" = (
/turf/closed/mineral/rogue,
/area/rogue/under/tomb)
"rX" = (
/obj/structure/table/wood,
/obj/item/reagent_containers/glass/cup/silver{
	pixel_y = 11;
	pixel_x = -2
	},
/obj/effect/spawner/lootdrop/general_loot_mid,
/turf/open/floor/rogue/wood,
/area/rogue/under/tomb/indoors/rest)
"sk" = (
/obj/structure/trap/bomb,
/turf/open/floor/carpet/red,
/area/rogue/under/tomb/indoors)
"tb" = (
/obj/machinery/light/rogue/torchholder/l,
/obj/effect/decal/cleanable/dirt/dust,
/turf/open/floor/rogue/blocks,
/area/rogue/under/tomb/indoors/rest)
"ue" = (
/mob/living/simple_animal/hostile/retaliate/rogue/trufflepig,
/obj/item/clothing/suit/roguetown/shirt/undershirt/artificer{
	pixel_x = 10;
	pixel_y = 6
	},
/turf/open/floor/carpet/royalblack,
/area/rogue/under/tomb/indoors/rest)
"uA" = (
/obj/structure/trap/wall_projectile{
	dir = 4
	},
/turf/open/floor/rogue/naturalstone,
/area/rogue/under/tomb)
"uM" = (
/obj/structure/table/wood,
/obj/effect/spawner/lootdrop/roguetown/dungeon/food,
/obj/effect/spawner/lootdrop/roguetown/dungeon/food,
/obj/effect/spawner/lootdrop/roguetown/dungeon/food,
/turf/open/floor/rogue/cobble,
/area/rogue/under/tomb/indoors/rest)
"wk" = (
/obj/structure/roguerock,
/turf/open/floor/rogue/naturalstone,
/area/rogue/under/tomb)
"wP" = (
/obj/effect/decal/cleanable/dirt/dust,
/turf/open/floor/rogue/blocks,
/area/rogue/under/tomb/indoors/rest)
"wT" = (
/obj/effect/dungeon_directional_helper/north,
/turf/open/floor/rogue/dirt/road,
/area/rogue/under/tomb)
"xw" = (
/turf/closed/wall/mineral/rogue/craftstone,
/area/rogue/under/tomb/indoors/rest)
"xH" = (
/turf/closed/wall/mineral/rogue/decostone/center,
/area/rogue/under/tomb/indoors)
"yk" = (
/turf/open/floor/rogue/dirt,
/area/rogue/under/tomb)
"yU" = (
/obj/structure/stairs/stone{
	dir = 1;
	icon_state = "stonestairs"
	},
/obj/structure/fluff/railing/border{
	dir = 4
	},
/turf/open/floor/rogue/cobble,
/area/rogue/under/tomb/indoors/rest)
"zu" = (
/obj/effect/decal/cleanable/dirt/dust,
/obj/machinery/light/rogue/oven/south,
/obj/structure/fluff/railing/border,
/turf/open/floor/rogue/wood,
/area/rogue/under/tomb/indoors/rest)
"zH" = (
/obj/effect/decal/cobbleedge{
	dir = 6
	},
/turf/open/floor/rogue/naturalstone,
/area/rogue/under/tomb)
"Ae" = (
/obj/effect/decal/cobbleedge{
	dir = 9
	},
/turf/open/floor/rogue/naturalstone,
/area/rogue/under/tomb)
"BZ" = (
/obj/effect/decal/cobbleedge{
	dir = 8
	},
/turf/open/floor/rogue/naturalstone,
/area/rogue/under/tomb)
"Cl" = (
/obj/effect/dungeon_directional_helper/east,
/turf/open/floor/rogue/naturalstone,
/area/rogue/under/tomb)
"CU" = (
/turf/open/floor/carpet/red,
/area/rogue/under/tomb/indoors)
"Dt" = (
/obj/structure/mannequin/male,
/turf/open/floor/rogue/herringbone,
/area/rogue/under/tomb/indoors)
"Em" = (
/obj/structure/closet/crate/chest/neu,
/obj/item/alch/firedust,
/obj/item/alch/magicdust,
/obj/item/alch/earthdust,
/obj/item/alch/coaldust,
/obj/item/alch/coaldust,
/obj/effect/decal/cleanable/dirt/dust,
/turf/open/floor/rogue/blocks,
/area/rogue/under/tomb/indoors/rest)
"Ez" = (
/turf/open/floor/rogue/cobble,
/area/rogue/under/tomb/indoors/rest)
"EP" = (
/obj/structure/mineral_door/wood/red,
/turf/open/floor/rogue/blocks,
/area/rogue/under/tomb/indoors/rest)
"FK" = (
/obj/effect/decal/cleanable/dirt/dust,
/turf/open/floor/rogue/cobble,
/area/rogue/under/tomb/indoors/rest)
"GS" = (
/obj/structure/rack/rogue,
/obj/item/reagent_containers/glass/bucket/pot,
/turf/open/floor/rogue/wood,
/area/rogue/under/tomb/indoors/rest)
"Ih" = (
/obj/item/clothing/gloves/roguetown/leather{
	pixel_x = -7;
	pixel_y = -9
	},
/obj/effect/decal/cleanable/vomit/old,
/turf/open/floor/carpet/royalblack,
/area/rogue/under/tomb/indoors/rest)
"IF" = (
/obj/structure/fluff/railing/border,
/turf/open/floor/rogue/wood,
/area/rogue/under/tomb/indoors/rest)
"JF" = (
/obj/effect/decal/cleanable/dirt/dust,
/obj/structure/fluff/railing/border{
	dir = 9
	},
/turf/open/floor/rogue/wood,
/area/rogue/under/tomb/indoors/rest)
"Kz" = (
/turf/closed/wall/mineral/rogue/decostone,
/area/rogue/under/tomb/indoors)
"LP" = (
/obj/item/clothing/under/roguetown/skirt/random{
	pixel_x = 8;
	pixel_y = 9
	},
/obj/effect/decal/cleanable/vomit/old,
/turf/open/floor/carpet/royalblack,
/area/rogue/under/tomb/indoors/rest)
"Mo" = (
/obj/structure/mannequin,
/turf/open/floor/rogue/herringbone,
/area/rogue/under/tomb/indoors)
"ME" = (
/obj/effect/decal/shadow_floor{
	dir = 5
	},
/obj/effect/decal/cleanable/dirt/dust,
/obj/structure/fluff/railing/border{
	dir = 5
	},
/turf/open/floor/rogue/cobble,
/area/rogue/under/tomb/indoors/rest)
"Nc" = (
/obj/effect/decal/cleanable/dirt/dust,
/obj/structure/fluff/railing/border{
	dir = 8
	},
/turf/open/floor/rogue/wood,
/area/rogue/under/tomb/indoors/rest)
"OK" = (
/obj/structure/fluff/railing/border{
	dir = 4
	},
/obj/structure/table/wood,
/obj/effect/spawner/lootdrop/general_loot_low/x3,
/turf/open/floor/rogue/wood,
/area/rogue/under/tomb/indoors/rest)
"Pa" = (
/obj/item/clothing/neck/roguetown/psicross/g{
	pixel_x = -6;
	pixel_y = 0
	},
/obj/structure/table/wood,
/obj/item/rogueweapon/huntingknife/idagger/silver{
	pixel_x = 6;
	pixel_y = 5
	},
/turf/open/floor/carpet/red,
/area/rogue/under/tomb/indoors)
"PE" = (
/obj/structure/roguerock,
/turf/open/floor/rogue/cobblerock,
/area/rogue/under/tomb)
"PI" = (
/obj/structure/rack/rogue/shelf/big{
	pixel_y = 0
	},
/obj/item/reagent_containers/glass/bucket{
	pixel_x = 5
	},
/obj/item/natural/cloth{
	pixel_x = -4;
	pixel_y = 5
	},
/obj/effect/decal/cleanable/dirt/dust,
/turf/open/floor/rogue/blocks,
/area/rogue/under/tomb/indoors/rest)
"PL" = (
/obj/structure/fluff/railing/border{
	dir = 6
	},
/turf/open/floor/rogue/wood,
/area/rogue/under/tomb/indoors/rest)
"Qh" = (
/obj/effect/dungeon_directional_helper/west,
/turf/open/floor/rogue/naturalstone,
/area/rogue/under/tomb)
"QB" = (
/obj/machinery/light/rogue/torchholder/r,
/turf/open/floor/rogue/cobble,
/area/rogue/under/tomb/indoors/rest)
"QE" = (
/obj/structure/table/wood,
/obj/effect/decal/shadow_floor,
/obj/structure/bars{
	icon_state = "barsbent";
	layer = 2.81
	},
/turf/open/floor/rogue/blocks,
/area/rogue/under/tomb/indoors/rest)
"Ra" = (
/obj/effect/decal/cobbleedge{
	dir = 1
	},
/turf/open/floor/rogue/naturalstone,
/area/rogue/under/tomb)
"Rb" = (
/turf/open/floor/rogue/wood,
/area/rogue/under/tomb/indoors/rest)
"Rh" = (
/obj/structure/closet/crate/chest/neu,
/obj/effect/spawner/lootdrop/potion_ingredient/herb,
/obj/effect/spawner/lootdrop/potion_ingredient/herb,
/obj/effect/spawner/lootdrop/potion_ingredient/herb,
/obj/effect/spawner/lootdrop/potion_ingredient/herb,
/obj/effect/spawner/lootdrop/potion_ingredient/herb,
/obj/effect/decal/cleanable/dirt/dust,
/turf/open/floor/rogue/blocks,
/area/rogue/under/tomb/indoors/rest)
"Ru" = (
/obj/machinery/light/rogue/lanternpost{
	dir = 1
	},
/turf/open/floor/rogue/cobble,
/area/rogue/under/tomb)
"Rv" = (
/obj/effect/decal/shadow_floor,
/obj/effect/decal/cleanable/dirt/dust,
/turf/open/floor/rogue/blocks,
/area/rogue/under/tomb/indoors/rest)
"RI" = (
/obj/structure/flora/roguetree/stump,
/turf/open/floor/rogue/dirt/road,
/area/rogue/under/tomb)
"RP" = (
/obj/structure/closet/crate/roguecloset/crafted,
/obj/item/clothing/ring/silver,
/turf/open/floor/carpet/royalblack,
/area/rogue/under/tomb/indoors/rest)
"Sc" = (
/turf/open/floor/rogue/blocks/green,
/area/rogue/under/tomb/indoors/rest)
"Sn" = (
/obj/structure/mineral_door/wood/deadbolt{
	dir = 1
	},
/obj/effect/mapping_helpers/access/locker,
/obj/effect/decal/shadow_floor,
/turf/open/floor/rogue/blocks,
/area/rogue/under/tomb/indoors/rest)
"SB" = (
/obj/machinery/light/rogue/candle/weak/l,
/turf/open/floor/rogue/herringbone,
/area/rogue/under/tomb/indoors)
"Ul" = (
/obj/effect/decal/cleanable/dirt/dust,
/obj/machinery/light/rogue/oven/south,
/obj/structure/fluff/railing/border{
	dir = 10
	},
/turf/open/floor/rogue/wood,
/area/rogue/under/tomb/indoors/rest)
"Vd" = (
/obj/effect/decal/cleanable/dirt/dust,
/obj/structure/fluff/railing/border{
	dir = 4
	},
/turf/open/floor/rogue/wood,
/area/rogue/under/tomb/indoors/rest)
"WJ" = (
/obj/structure/stairs/stone,
/obj/machinery/light/rogue/candle/r,
/turf/open/floor/rogue/cobble,
/area/rogue/under/tomb/indoors/rest)
"WK" = (
/obj/structure/flora/roguegrass/herb/random,
/turf/open/floor/rogue/dirt,
/area/rogue/under/tomb)
"WV" = (
/obj/machinery/light/rogue/hearth,
/obj/item/cooking/pan,
/turf/open/floor/rogue/blocks,
/area/rogue/under/tomb/indoors/rest)
"Xw" = (
/obj/structure/mineral_door/bars,
/turf/open/floor/rogue/herringbone,
/area/rogue/under/tomb/indoors)
"Ya" = (
/turf/open/floor/rogue/naturalstone,
/area/rogue/under/tomb)
"Yk" = (
/obj/structure/table/wood,
/obj/item/reagent_containers/glass/mortar{
	pixel_y = 9
	},
/turf/open/floor/rogue/cobble,
/area/rogue/under/tomb/indoors/rest)
"Zj" = (
/turf/open/floor/rogue/blocks,
/area/rogue/under/tomb/indoors/rest)
"Zq" = (
/obj/effect/decal/shadow_floor{
	dir = 1
	},
/obj/effect/decal/cleanable/dirt/dust,
/turf/open/floor/rogue/cobble,
/area/rogue/under/tomb/indoors/rest)
"Zv" = (
/turf/open/transparent/openspace,
/area/rogue/under/tomb)
"Zz" = (
/obj/machinery/light/rogue/candle/r,
/obj/structure/bed/rogue/inn,
/obj/item/bedsheet/rogue/wool,
/turf/open/floor/carpet/royalblack,
/area/rogue/under/tomb/indoors/rest)
"ZJ" = (
/obj/effect/decal/cleanable/dirt/dust,
/turf/open/floor/carpet/purple,
/area/rogue/under/tomb/indoors/rest)

(1,1,1) = {"
oZ
oZ
oZ
oZ
oZ
oZ
oZ
oZ
yk
lA
lA
lA
Ya
Qh
Ya
Ya
Ya
oZ
oZ
oZ
"}
(2,1,1) = {"
oZ
oZ
oZ
oZ
oZ
oZ
oZ
WK
yk
lA
lA
Ya
Ya
Ya
Ya
Ya
oZ
oZ
oZ
oZ
"}
(3,1,1) = {"
oZ
oZ
oZ
oZ
oZ
oZ
oZ
oZ
oZ
yk
lA
Ya
wk
Ya
Ya
Ya
oZ
oZ
oZ
oZ
"}
(4,1,1) = {"
oZ
oZ
oZ
oZ
oZ
oZ
oZ
oZ
oZ
yk
Ya
Ya
Ya
Ya
Ya
Ya
oZ
oZ
oZ
oZ
"}
(5,1,1) = {"
oZ
oZ
oZ
oZ
oZ
oZ
oZ
oZ
Ya
Ya
Ya
Ya
oZ
Ya
Ya
oZ
oZ
oZ
oZ
oZ
"}
(6,1,1) = {"
oZ
oZ
oZ
oZ
oZ
oZ
oZ
lA
Ya
Ya
wk
Ya
oZ
Ya
Ya
oZ
oZ
oZ
oZ
oZ
"}
(7,1,1) = {"
oZ
oZ
WK
oZ
oZ
oZ
yk
lA
lA
Ya
Ya
Ya
Ya
Ya
yk
oZ
bT
bT
PE
oZ
"}
(8,1,1) = {"
oZ
oZ
yk
oZ
lA
lA
lA
lA
oZ
Ya
Ya
Ya
Ya
Ya
yk
oZ
oZ
bT
bT
oZ
"}
(9,1,1) = {"
lA
lA
lA
lA
lA
lA
Ya
lA
Ya
Ya
Ya
Ya
Ya
yk
lA
oZ
oZ
bT
oZ
oZ
"}
(10,1,1) = {"
wT
lA
lA
lA
lA
lA
Ya
Ya
Ya
Ya
Ya
Ya
Ya
lA
lA
oZ
bT
bT
oZ
oZ
"}
(11,1,1) = {"
lA
Ya
Ya
Ya
Ya
Ya
Ya
Ae
BZ
fx
Ya
Ya
Ya
lA
lA
yk
lA
oZ
oZ
oZ
"}
(12,1,1) = {"
fv
fv
fv
fv
fv
Ya
Ya
Ra
Ru
fg
Ya
Ya
lA
lA
oZ
yk
oZ
oZ
oZ
oZ
"}
(13,1,1) = {"
fv
Yk
au
jI
fv
fv
fv
fv
fv
zH
Ya
Ya
lA
oZ
oZ
yk
yk
oZ
oZ
oZ
"}
(14,1,1) = {"
fv
cB
cB
Ez
QE
Zj
tb
Zj
fv
Ya
Ya
Ya
lA
oZ
cI
yk
WK
oZ
oZ
oZ
"}
(15,1,1) = {"
fv
ic
Sc
Ez
Sn
wP
Zj
Zj
di
Ya
Ya
Ya
lA
oZ
oZ
oZ
oZ
oZ
oZ
oZ
"}
(16,1,1) = {"
fv
Sc
Sc
FK
fv
fv
fv
fv
fv
Ya
Ya
Ya
Ya
lA
oZ
oZ
oZ
oZ
oZ
oZ
"}
(17,1,1) = {"
fv
uM
FK
FK
Rv
fv
gb
Em
fv
Ya
Ya
Ya
Ya
Ya
oZ
oZ
oZ
oZ
oZ
oZ
"}
(18,1,1) = {"
fv
Ez
FK
QB
Rv
EP
wP
Rh
fv
Ya
Ya
Ya
Ya
Ya
yk
oZ
oZ
oZ
oZ
oZ
"}
(19,1,1) = {"
fv
Ez
qm
fv
gs
fv
wP
PI
fv
Ya
Ya
Ya
Ya
Ya
oZ
oZ
oZ
oZ
oZ
oZ
"}
(20,1,1) = {"
fv
fv
fv
fv
fv
fv
fv
fv
fv
Ya
Ya
Cl
Ya
Ya
oZ
oZ
oZ
oZ
oZ
oZ
"}

(1,1,2) = {"
oZ
oZ
oZ
oZ
oZ
oZ
oZ
oZ
oZ
bT
bT
Ya
Ya
Zv
Zv
Zv
Zv
oZ
oZ
oZ
"}
(2,1,2) = {"
oZ
oZ
oZ
oZ
WK
oZ
oZ
oZ
oZ
oZ
bT
Ya
Ya
Zv
Zv
Zv
oZ
oZ
oZ
oZ
"}
(3,1,2) = {"
oZ
oZ
oZ
oZ
gP
yk
PE
oZ
oZ
oZ
PE
Ya
Ya
Ya
Zv
Zv
oZ
oZ
oZ
oZ
"}
(4,1,2) = {"
oZ
oZ
oZ
oZ
yk
RI
bT
oZ
oZ
oZ
oZ
Ya
bT
Ya
wk
Zv
oZ
oZ
oZ
oZ
"}
(5,1,2) = {"
oZ
oZ
oZ
oZ
lA
lA
lA
oZ
oZ
oZ
oZ
bT
PE
bT
Ya
oZ
oZ
oZ
oZ
oZ
"}
(6,1,2) = {"
oZ
oZ
oZ
oZ
lA
Ya
lA
lA
oZ
oZ
oZ
bT
bT
Ya
Ya
oZ
oZ
oZ
oZ
oZ
"}
(7,1,2) = {"
oZ
oZ
oZ
oZ
Ya
oZ
oZ
lA
Ya
Zv
oZ
Ya
PE
Ya
Ya
Ya
Zv
Zv
Zv
oZ
"}
(8,1,2) = {"
oZ
Ya
Ya
oZ
Zv
oZ
oZ
Ya
Ya
Zv
Zv
Ya
Ya
oZ
oZ
oZ
oZ
Zv
Zv
oZ
"}
(9,1,2) = {"
Ya
Ya
Ya
Zv
Zv
Zv
oZ
Ya
Zv
Zv
Zv
Zv
Ya
oZ
oZ
oZ
oZ
oZ
oZ
oZ
"}
(10,1,2) = {"
Ya
Ya
Ya
Ya
Zv
Zv
Ya
Ya
Zv
Zv
Zv
Zv
Zv
Zv
oZ
oZ
Kz
xH
Kz
oZ
"}
(11,1,2) = {"
Ya
Ya
Ya
Zv
Zv
Zv
Zv
Zv
Zv
Zv
Zv
Zv
oZ
oZ
oZ
Kz
js
Pa
js
Kz
"}
(12,1,2) = {"
fv
fv
fv
fv
fv
Zv
Zv
Zv
Zv
Zv
Zv
Zv
oZ
oZ
oZ
Kz
aS
CU
SB
Kz
"}
(13,1,2) = {"
fv
fv
zu
WV
fv
fv
fv
fv
fv
Zv
Zv
Zv
oZ
oZ
oZ
Kz
qe
sk
Mo
Kz
"}
(14,1,2) = {"
fv
fv
Ul
Nc
JF
bm
ke
rX
fv
Zv
Zv
Zv
Zv
oZ
oZ
Kz
Dt
CU
qe
Kz
"}
(15,1,2) = {"
fv
GS
bm
qz
bm
hz
Rb
bm
fv
Zv
Zv
Zv
Zv
oZ
oZ
Kz
Kz
Xw
Kz
Kz
"}
(16,1,2) = {"
fv
bm
Rb
ZJ
aC
xw
xw
ok
fv
Zv
Zv
Zv
Zv
Zv
oZ
oZ
Ya
uA
Ya
oZ
"}
(17,1,2) = {"
fv
PL
Vd
nX
OK
xw
RP
LP
fv
Zv
Zv
Zv
Zv
Zv
oZ
oZ
oZ
Ya
oZ
oZ
"}
(18,1,2) = {"
fv
PL
yU
id
ME
xw
ue
bY
fv
Zv
Zv
Zv
Zv
Zv
Zv
Ya
Ya
Ya
oZ
oZ
"}
(19,1,2) = {"
fv
IF
pK
WJ
Zq
xw
Ih
Zz
fv
Zv
Zv
Zv
Zv
Zv
oZ
oZ
oZ
Ya
oZ
oZ
"}
(20,1,2) = {"
fv
fv
fv
fv
fv
fv
fv
fv
fv
Zv
Zv
Zv
Zv
Zv
oZ
oZ
oZ
qV
oZ
oZ
"}
