//MAP CONVERTED BY dmm2tgm.py THIS HEADER COMMENT PREVENTS RECONVERSION, DO NOT REMOVE
"ah" = (
/obj/item/flashlight/flare/torch/metal,
/turf/open/floor/rogue/naturalstone,
/area/rogue/under/tomb/cave)
"az" = (
/obj/structure/closet/dirthole/closed,
/mob/living/carbon/human/species/skeleton/npc/mediumspread,
/obj/effect/spawner/lootdrop/general_loot_hi,
/turf/open/floor/rogue/dirt,
/area/rogue/under/tomb)
"aG" = (
/obj/item/natural/rock,
/turf/open/floor/rogue/naturalstone,
/area/rogue/under/tomb/cave)
"aH" = (
/turf/open/floor/rogue/naturalstone,
/area/rogue/under/tomb/cave)
"aX" = (
/turf/open/transparent/openspace,
/area/rogue/under/tomb/cave)
"bd" = (
/obj/structure/chair/stool/rogue,
/mob/living/simple_animal/hostile/retaliate/rogue/bigrat{
	name = "Spoon Sharpener"
	},
/obj/effect/mapping_helpers/floor_clothing_equipper,
/obj/item/kitchen/spoon/iron,
/obj/item/kitchen/spoon/iron,
/turf/open/floor/rogue/naturalstone,
/area/rogue/under/tomb/cave)
"bo" = (
/obj/structure/pillory/double,
/turf/open/floor/rogue/naturalstone,
/area/rogue/under/tomb/cave)
"cc" = (
/obj/structure/closet/dirthole/grave,
/obj/item/rogueweapon/shovel,
/turf/open/floor/rogue/dirt/road,
/area/rogue/under/tomb)
"dr" = (
/obj/item/natural/stone,
/turf/open/floor/rogue/naturalstone,
/area/rogue/under/tomb/cave)
"dE" = (
/obj/structure/closet/dirthole/closed,
/mob/living/carbon/human/species/skeleton/npc/no_equipment,
/obj/effect/spawner/lootdrop/roguetown/dungeon/weapons,
/obj/effect/mapping_helpers/floor_clothing_equipper,
/obj/effect/spawner/lootdrop/roguetown/dungeon/armor,
/turf/open/floor/rogue/dirt,
/area/rogue/under/tomb)
"ew" = (
/obj/structure/closet/dirthole/closed,
/obj/item/clothing/neck/roguetown/gorget/copper,
/obj/item/clothing/head/roguetown/helmet/coppercap,
/mob/living/carbon/human/species/skeleton/npc/mediumspread,
/turf/open/floor/rogue/dirt,
/area/rogue/under/tomb)
"eK" = (
/obj/item/natural/stone{
	pixel_x = 2;
	pixel_y = -8
	},
/turf/open/floor/rogue/naturalstone,
/area/rogue/under/tomb/cave)
"eL" = (
/obj/effect/spawner/roguemap/beartrap,
/turf/open/floor/rogue/naturalstone,
/area/rogue/under/tomb/cave)
"fm" = (
/obj/item/natural/rock/dungeon,
/turf/open/floor/rogue/dirt/road,
/area/rogue/under/tomb/cave)
"fy" = (
/obj/structure/closet/dirthole,
/turf/open/floor/rogue/dirt/road,
/area/rogue/under/tomb)
"gp" = (
/obj/item/rogueweapon/shovel,
/turf/open/floor/rogue/dirt,
/area/rogue/under/tomb)
"gT" = (
/obj/effect/spawner/lootdrop/random_gem,
/turf/open/floor/rogue/cobblerock,
/area/rogue/under/tomb/cave)
"hQ" = (
/obj/structure/flora/roguegrass/bush/westleach,
/turf/open/floor/rogue/grassyel,
/area/rogue/under/tomb/cave)
"hY" = (
/obj/structure/closet/dirthole/closed,
/obj/effect/spawner/lootdrop/roguetown/dungeon/armor,
/mob/living/carbon/human/species/skeleton/npc/mediumspread,
/obj/structure/closet/burial_shroud,
/turf/open/floor/rogue/dirt/road,
/area/rogue/under/tomb)
"if" = (
/obj/structure/closet/dirthole/closed,
/obj/structure/closet/burial_shroud,
/mob/living/carbon/human/species/skeleton/npc/mediumspread,
/obj/effect/spawner/lootdrop/roguetown/dungeon/weapons,
/turf/open/floor/rogue/dirt,
/area/rogue/under/tomb)
"in" = (
/turf/open/floor/rogue/dirt,
/area/rogue/under/tomb)
"iv" = (
/obj/structure/closet/dirthole/grave,
/obj/structure/closet/crate/coffin,
/obj/item/organ/stomach,
/obj/item/organ/lungs,
/obj/item/organ/heart,
/obj/item/organ/tongue,
/obj/item/organ/brain,
/turf/open/floor/rogue/dirt,
/area/rogue/under/tomb)
"iL" = (
/obj/structure/flora/roguegrass/maneater,
/turf/open/floor/rogue/dirt/road,
/area/rogue/under/tomb/cave)
"iR" = (
/turf/closed/mineral/rogue/bedrock,
/area/rogue/under/tomb)
"jc" = (
/obj/effect/dungeon_directional_helper/east,
/turf/open/floor/rogue/grassyel,
/area/rogue/under/tomb/cave)
"kh" = (
/obj/structure/roguerock,
/turf/open/floor/rogue/dirt,
/area/rogue/under/tomb/cave)
"kp" = (
/turf/open/water/swamp,
/area/rogue/under/tomb)
"lA" = (
/obj/structure/closet/dirthole/grave,
/turf/open/floor/rogue/dirt,
/area/rogue/under/tomb)
"mj" = (
/obj/structure/closet/dirthole/closed,
/obj/effect/spawner/lootdrop/general_loot_low,
/obj/structure/closet/burial_shroud,
/mob/living/carbon/human/species/skeleton/npc/mediumspread,
/turf/open/floor/rogue/dirt,
/area/rogue/under/tomb)
"mu" = (
/obj/structure/roguerock,
/turf/open/floor/rogue/naturalstone,
/area/rogue/under/tomb/cave)
"mJ" = (
/obj/structure/flora/roguegrass/herb/atropa,
/turf/open/floor/rogue/grassyel,
/area/rogue/under/tomb/cave)
"mN" = (
/obj/item/natural/stone{
	pixel_x = 9;
	pixel_y = 5
	},
/turf/open/floor/rogue/cobblerock,
/area/rogue/under/tomb/cave)
"nB" = (
/turf/closed/wall/mineral/rogue/decostone,
/area/rogue/under/tomb)
"oB" = (
/obj/structure/stairs/stone{
	dir = 1
	},
/turf/open/floor/rogue/herringbone,
/area/rogue/under/tomb/cave)
"oM" = (
/mob/living/carbon/human/species/skeleton/npc/bogguard,
/obj/effect/spawner/lootdrop/general_loot_hi,
/obj/structure/closet/dirthole/closed,
/obj/item/clothing/head/peaceflower{
	pixel_y = -10;
	pixel_x = -8
	},
/obj/item/reagent_containers/food/snacks/grown/rogue/poppy{
	pixel_x = 9
	},
/turf/open/floor/rogue/dirt,
/area/rogue/under/tomb)
"pr" = (
/turf/open/floor/rogue/herringbone,
/area/rogue/under/tomb/cave)
"qA" = (
/obj/structure/fluff/clodpile,
/turf/open/floor/rogue/dirt,
/area/rogue/under/tomb)
"rp" = (
/turf/closed/wall/mineral/rogue/decostone/end{
	dir = 8
	},
/area/rogue/under/tomb/cave)
"rr" = (
/obj/structure/closet/dirthole/closed,
/obj/item/clothing/suit/roguetown/armor/plate/cuirass/aalloy,
/turf/open/floor/rogue/dirt,
/area/rogue/under/tomb)
"rU" = (
/obj/structure/closet/dirthole/closed,
/obj/item/rogueweapon/shield/tower,
/obj/effect/spawner/lootdrop/roguetown/dungeon/weapons,
/obj/effect/mapping_helpers/floor_clothing_equipper,
/mob/living/carbon/human/species/skeleton/npc/no_equipment,
/turf/open/floor/rogue/dirt,
/area/rogue/under/tomb)
"si" = (
/obj/structure/flora/ausbushes/reedbush,
/turf/open/water/swamp,
/area/rogue/under/tomb/cave)
"sF" = (
/obj/structure/closet/dirthole/closed,
/obj/effect/spawner/lootdrop/roguetown/dungeon/weapons,
/turf/open/floor/rogue/dirt,
/area/rogue/under/tomb)
"tc" = (
/turf/closed/wall/mineral/rogue/decostone/end{
	dir = 4
	},
/area/rogue/under/tomb/cave)
"tW" = (
/obj/item/natural/stone{
	pixel_x = -3;
	pixel_y = 5
	},
/turf/open/floor/rogue/naturalstone,
/area/rogue/under/tomb/cave)
"vd" = (
/obj/effect/decal/cleanable/blood/splatter,
/turf/open/floor/rogue/naturalstone,
/area/rogue/under/tomb/cave)
"vf" = (
/obj/item/natural/rock,
/obj/item/natural/stone{
	pixel_x = -8;
	pixel_y = -10
	},
/obj/item/natural/stone{
	pixel_x = -13;
	pixel_y = 7
	},
/obj/item/natural/stone{
	pixel_x = 6;
	pixel_y = -9
	},
/obj/item/rogueweapon/pick/stone{
	pixel_x = -1;
	pixel_y = 1
	},
/turf/open/floor/rogue/naturalstone,
/area/rogue/under/tomb/cave)
"vg" = (
/turf/open/floor/rogue/cobblerock,
/area/rogue/under/tomb/cave)
"vl" = (
/obj/structure/glowshroom,
/turf/open/water/swamp,
/area/rogue/under/tomb/cave)
"vH" = (
/obj/effect/dungeon_directional_helper/north,
/turf/open/floor/rogue/dirt/road,
/area/rogue/under/tomb)
"wj" = (
/obj/structure/glowshroom{
	icon_state = "glowshroom2"
	},
/turf/open/water/swamp,
/area/rogue/under/tomb/cave)
"wu" = (
/obj/structure/closet/dirthole/closed,
/mob/living/carbon/human/species/skeleton/npc/mediumspread,
/turf/open/floor/rogue/dirt,
/area/rogue/under/tomb)
"xc" = (
/obj/structure/roguerock,
/turf/open/floor/rogue/dirt/road,
/area/rogue/under/tomb/cave)
"xy" = (
/obj/structure/closet/dirthole/closed,
/obj/effect/spawner/lootdrop/general_loot_low,
/mob/living/carbon/human/species/skeleton/npc/dungeon,
/turf/open/floor/rogue/dirt/road,
/area/rogue/under/tomb)
"xP" = (
/obj/structure/gravemarker,
/obj/structure/closet/dirthole/closed/loot,
/turf/open/floor/rogue/dirt,
/area/rogue/under/tomb)
"yG" = (
/obj/structure/closet/dirthole/closed,
/mob/living/carbon/human/species/skeleton/npc/bogguard,
/obj/effect/spawner/lootdrop/roguetown/dungeon/armor,
/turf/open/floor/rogue/dirt,
/area/rogue/under/tomb)
"yN" = (
/turf/closed/mineral/random/rogue,
/area/rogue/under/tomb/cave)
"zU" = (
/obj/item/natural/stone{
	pixel_x = -6;
	pixel_y = -7
	},
/obj/item/natural/stone{
	pixel_x = 9;
	pixel_y = 5
	},
/turf/open/floor/rogue/naturalstone,
/area/rogue/under/tomb/cave)
"AF" = (
/obj/item/grown/log/tree/small,
/turf/closed/mineral/rogue/bedrock,
/area/rogue/under/tomb)
"AG" = (
/obj/structure/gravemarker,
/obj/structure/closet/dirthole/closed/loot,
/turf/open/floor/rogue/dirt/road,
/area/rogue/under/tomb)
"AQ" = (
/obj/item/restraints/legcuffs/beartrap/armed/camouflage,
/turf/open/floor/rogue/naturalstone,
/area/rogue/under/tomb/cave)
"Bh" = (
/obj/structure/glowshroom{
	icon_state = "glowshroom_A3"
	},
/turf/open/floor/rogue/dirt,
/area/rogue/under/tomb/cave)
"BF" = (
/obj/structure/roguerock,
/turf/open/floor/rogue/cobblerock,
/area/rogue/under/tomb/cave)
"Cj" = (
/obj/item/ingot/gold{
	pixel_x = 4;
	pixel_y = 3
	},
/turf/open/water/swamp/deep,
/area/rogue/under/tomb/cave)
"Co" = (
/obj/effect/decal/cleanable/blood/old,
/turf/open/floor/rogue/naturalstone,
/area/rogue/under/tomb/cave)
"Cq" = (
/obj/item/natural/rock,
/turf/open/floor/rogue/cobblerock,
/area/rogue/under/tomb/cave)
"CI" = (
/obj/structure/glowshroom,
/turf/open/floor/rogue/dirt,
/area/rogue/under/tomb/cave)
"CM" = (
/turf/open/floor/rogue/dirt/road,
/area/rogue/under/tomb/cave)
"CZ" = (
/obj/structure/closet/dirthole/closed,
/turf/open/floor/rogue/dirt,
/area/rogue/under/tomb)
"Dz" = (
/obj/effect/decal/cleanable/blood/splatter,
/turf/open/floor/rogue/cobblerock,
/area/rogue/under/tomb/cave)
"DA" = (
/obj/structure/closet/dirthole/grave,
/obj/structure/closet/burial_shroud,
/obj/effect/spawner/lootdrop/roguetown/dungeon/weapons,
/turf/open/floor/rogue/dirt/road,
/area/rogue/under/tomb)
"DH" = (
/obj/item/natural/stone{
	pixel_x = 6;
	pixel_y = -5
	},
/obj/item/natural/stone{
	pixel_x = -3;
	pixel_y = 7
	},
/turf/open/floor/rogue/naturalstone,
/area/rogue/under/tomb/cave)
"Ei" = (
/obj/item/kitchen/spoon/iron{
	pixel_y = 3;
	pixel_x = 7
	},
/obj/item/kitchen/spoon/iron{
	pixel_x = -1;
	pixel_y = 4
	},
/obj/item/kitchen/spoon/iron{
	pixel_x = -3;
	pixel_y = -1
	},
/obj/item/kitchen/spoon/iron{
	pixel_x = 3
	},
/obj/item/kitchen/spoon/iron{
	pixel_x = -8;
	pixel_y = 3
	},
/turf/open/floor/rogue/naturalstone,
/area/rogue/under/tomb/cave)
"Eq" = (
/obj/item/natural/stone{
	pixel_x = 9;
	pixel_y = 5
	},
/obj/item/natural/stone{
	pixel_x = -6;
	pixel_y = -7
	},
/turf/open/floor/rogue/naturalstone,
/area/rogue/under/tomb/cave)
"EE" = (
/obj/item/natural/dirtclod,
/turf/open/floor/rogue/dirt,
/area/rogue/under/tomb)
"EP" = (
/mob/living/carbon/human/species/skeleton/npc/mediumspread,
/turf/open/water/swamp/deep,
/area/rogue/under/tomb/cave)
"Ft" = (
/mob/living/carbon/human/species/skeleton/npc/mediumspread,
/turf/open/floor/rogue/dirt/road,
/area/rogue/under/tomb)
"Fy" = (
/obj/structure/glowshroom{
	icon_state = "glowshroom_A1"
	},
/turf/open/floor/rogue/dirt,
/area/rogue/under/tomb/cave)
"GC" = (
/turf/open/water/swamp/deep,
/area/rogue/under/tomb/cave)
"GJ" = (
/obj/effect/dungeon_directional_helper/west,
/turf/open/floor/rogue/dirt/road,
/area/rogue/under/tomb/cave)
"Hc" = (
/mob/living/carbon/human/species/skeleton/npc/no_equipment,
/obj/effect/mapping_helpers/floor_clothing_equipper,
/obj/item/rogueweapon/shovel,
/obj/item/clothing/under/roguetown/trou/leather/mourning,
/obj/item/clothing/suit/roguetown/shirt/robe/necra,
/obj/item/burial_shroud,
/obj/item/clothing/neck/roguetown/psicross/necra,
/turf/open/floor/rogue/dirt/road,
/area/rogue/under/tomb)
"IB" = (
/obj/item/natural/rock/dungeon,
/turf/open/floor/rogue/naturalstone,
/area/rogue/under/tomb/cave)
"IP" = (
/obj/machinery/light/rogue/firebowl/standing/blue,
/turf/open/floor/rogue/dirt/road,
/area/rogue/under/tomb)
"Lx" = (
/obj/structure/closet/dirthole/grave,
/turf/open/floor/rogue/dirt/road,
/area/rogue/under/tomb)
"Ly" = (
/obj/structure/closet/dirthole/grave,
/obj/structure/closet/burial_shroud,
/mob/living/carbon/human/species/skeleton/npc/no_equipment,
/turf/open/floor/rogue/dirt,
/area/rogue/under/tomb)
"MV" = (
/obj/effect/decal/cleanable/blood/old,
/obj/effect/spawner/roguemap/beartrap,
/turf/open/floor/rogue/naturalstone,
/area/rogue/under/tomb/cave)
"MX" = (
/obj/structure/fluff/grindwheel,
/turf/open/floor/rogue/naturalstone,
/area/rogue/under/tomb/cave)
"Nq" = (
/turf/open/water/swamp,
/area/rogue/under/tomb/cave)
"Nr" = (
/obj/machinery/light/rogue/torchholder/r,
/turf/open/floor/rogue/naturalstone,
/area/rogue/under/tomb/cave)
"NC" = (
/turf/open/floor/rogue/grassyel,
/area/rogue/under/tomb/cave)
"OL" = (
/obj/structure/glowshroom{
	icon_state = "glowshroom_A2"
	},
/turf/open/floor/rogue/dirt,
/area/rogue/under/tomb/cave)
"OW" = (
/obj/structure/closet/dirthole/closed,
/mob/living/carbon/human/species/skeleton/npc/mediumspread,
/turf/open/floor/rogue/dirt/road,
/area/rogue/under/tomb)
"Pt" = (
/obj/effect/spawner/roguemap/beartrap,
/turf/open/floor/rogue/cobblerock,
/area/rogue/under/tomb/cave)
"PD" = (
/obj/item/clothing/cloak/raincloak/mortus,
/turf/open/floor/rogue/dirt/road,
/area/rogue/under/tomb)
"Qk" = (
/obj/structure/closet/dirthole/closed,
/obj/effect/landmark/chest_or_mimic,
/obj/item/natural/rock/dungeon,
/turf/open/floor/rogue/dirt,
/area/rogue/under/tomb)
"QX" = (
/obj/item/clothing/head/roguetown/jester,
/obj/item/clothing/shoes/roguetown/jester,
/obj/item/clothing/suit/roguetown/shirt/jester,
/obj/item/clothing/under/roguetown/tights/jester,
/obj/effect/mapping_helpers/floor_clothing_equipper,
/obj/item/handheld_bell,
/mob/living/carbon/human/species/skeleton/npc/no_equipment,
/obj/item/kitchen/fork/iron,
/turf/open/floor/rogue/naturalstone,
/area/rogue/under/tomb/cave)
"Rk" = (
/obj/structure/closet/dirthole/closed,
/obj/effect/spawner/lootdrop/roguetown/dungeon/weapons,
/turf/open/floor/rogue/dirt/road,
/area/rogue/under/tomb)
"Sk" = (
/obj/structure/stairs/stone,
/turf/open/floor/rogue/herringbone,
/area/rogue/under/tomb/cave)
"SP" = (
/obj/structure/glowshroom{
	icon_state = "glowshroom2"
	},
/turf/open/floor/rogue/dirt,
/area/rogue/under/tomb/cave)
"SY" = (
/obj/effect/dungeon_directional_helper/south,
/turf/open/floor/rogue/dirt/road,
/area/rogue/under/tomb)
"To" = (
/turf/open/floor/rogue/dirt,
/area/rogue/under/tomb/cave)
"Vc" = (
/obj/structure/flora/roguegrass/bush,
/turf/open/floor/rogue/grassyel,
/area/rogue/under/tomb/cave)
"Wk" = (
/mob/living/carbon/human/species/skeleton/npc/no_equipment,
/obj/item/rogueweapon/shovel,
/obj/item/burial_shroud,
/obj/effect/mapping_helpers/floor_clothing_equipper,
/obj/item/clothing/under/roguetown/trou/leather/mourning,
/obj/item/clothing/suit/roguetown/shirt/robe/necra,
/turf/open/floor/rogue/dirt/road,
/area/rogue/under/tomb)
"WI" = (
/obj/structure/glowshroom{
	icon_state = "glowshroom3"
	},
/turf/open/water/swamp,
/area/rogue/under/tomb/cave)
"Xc" = (
/obj/item/grown/log/tree/small,
/turf/open/floor/rogue/naturalstone,
/area/rogue/under/tomb/cave)
"XK" = (
/turf/open/floor/rogue/dirt/road,
/area/rogue/under/tomb)
"XO" = (
/obj/structure/flora/rogueshroom/happy/random,
/turf/open/water/swamp,
/area/rogue/under/tomb/cave)
"XV" = (
/obj/item/natural/dirtclod,
/turf/open/floor/rogue/dirt/road,
/area/rogue/under/tomb)
"XW" = (
/turf/closed/wall/mineral/rogue/decostone,
/area/rogue/under/tomb/cave)
"Yg" = (
/obj/structure/closet/dirthole/closed,
/turf/open/floor/rogue/dirt/road,
/area/rogue/under/tomb)

(1,1,1) = {"
iR
iR
iR
iR
iR
iR
iR
iR
iR
iR
iR
iR
CM
CM
GJ
CM
iR
iR
iR
iR
iR
iR
iR
iR
iR
iR
iR
iR
iR
iR
"}
(2,1,1) = {"
iR
iR
iR
iR
iR
iR
iR
iR
iR
iR
To
To
CM
CM
CM
CM
CM
CM
aH
iR
iR
iR
iR
iR
iR
iR
iR
iR
iR
iR
"}
(3,1,1) = {"
iR
iR
iR
iR
iR
iR
iR
iR
iR
iR
iR
Nq
Nq
To
CM
CM
To
aH
iR
iR
iR
iR
CI
Nq
iR
iR
iR
iR
iR
iR
"}
(4,1,1) = {"
iR
iR
iR
iR
iR
iR
iR
iR
iR
iR
iR
iR
iR
kp
To
CM
CM
Nq
Nq
To
iR
To
aH
CM
iR
iR
iR
iR
iR
iR
"}
(5,1,1) = {"
iR
iR
iR
iR
iR
iR
iR
iR
iR
iR
iR
iR
iR
To
To
To
Nq
Nq
XO
Nq
Nq
aH
aH
XW
iR
iR
iR
iR
iR
iR
"}
(6,1,1) = {"
iR
iR
iR
iR
iR
iR
iR
iR
iR
iR
iR
iR
iR
iR
Nq
Nq
vl
XO
Nq
Nq
aH
aH
aH
aH
To
iR
iR
iR
iR
iR
"}
(7,1,1) = {"
iR
iR
iR
iR
iR
iR
iR
iR
iR
iR
iR
iR
iR
iR
iR
XO
Nq
Nq
Nq
To
Sk
tc
aH
aH
aH
Bh
iR
iR
iR
iR
"}
(8,1,1) = {"
iR
iR
iR
iR
iR
iR
iR
iR
iR
iR
iR
iR
iR
iR
iR
iR
Nq
vl
To
CM
Sk
rp
aH
XW
aH
iR
iR
iR
iR
iR
"}
(9,1,1) = {"
iR
iR
iR
iR
iR
iR
iR
iR
iR
iR
iR
iR
iR
iR
iR
iR
iR
Nq
aH
CM
CM
aH
aH
iR
iR
iR
iR
iR
iR
iR
"}
(10,1,1) = {"
iR
iR
iR
iR
iR
iR
iR
iR
iR
iR
iR
in
dE
dE
iR
iR
iR
iR
iR
iR
iR
aH
To
iR
iR
iR
iR
iR
iR
iR
"}
(11,1,1) = {"
iR
iR
iR
iR
iR
iR
iR
iR
in
CZ
az
in
XK
XK
Lx
iR
iR
iR
iR
iR
iR
iR
Nq
XW
iR
iR
iR
iR
iR
iR
"}
(12,1,1) = {"
iR
iR
iR
iR
Qk
EE
yG
in
qA
in
in
qA
IP
Lx
Wk
Lx
iR
iR
iR
iR
iR
iR
iR
iR
iR
iR
iR
AG
XK
XK
"}
(13,1,1) = {"
XK
XK
CZ
wu
in
in
XV
XK
XK
XK
XK
XK
PD
XK
XK
XK
qA
XK
CZ
CZ
hY
AG
iR
iR
Rk
Yg
XK
XK
XK
XK
"}
(14,1,1) = {"
XK
in
qA
qA
in
XK
XK
fy
XK
XK
iR
in
in
XK
in
XK
XK
XK
XK
in
XK
XK
XK
nB
XK
in
qA
iR
Lx
XK
"}
(15,1,1) = {"
in
in
XK
XK
XK
XK
Lx
XK
XK
fy
XK
XK
EE
qA
in
CZ
iR
wu
XK
XK
XV
in
XK
XK
in
in
XK
in
XK
XK
"}
(16,1,1) = {"
vH
XK
XK
XV
XK
fy
XK
qA
CZ
in
XK
Hc
XK
in
wu
iR
lA
XK
XK
XK
XK
in
qA
Lx
in
XK
XK
XK
in
SY
"}
(17,1,1) = {"
XK
XK
XK
XK
XK
XK
in
AG
iR
iR
EE
XK
fy
XK
in
in
in
XK
qA
in
in
XK
XK
nB
Lx
XK
qA
in
in
in
"}
(18,1,1) = {"
XK
XK
XK
fy
XK
in
EE
oM
iR
iR
xy
XV
XK
iR
iR
OW
XK
XK
XK
XK
XK
cc
XK
XK
XK
XK
Yg
Yg
iR
iR
"}
(19,1,1) = {"
iR
XK
XK
XK
XK
in
in
xP
iR
CZ
XK
lA
iR
iR
iR
iR
Yg
in
EE
fy
XK
XK
XK
Lx
DA
iR
iR
iR
iR
iR
"}
(20,1,1) = {"
iR
XK
XK
Ft
XV
XK
XK
XK
XK
XK
XK
CZ
iR
iR
iR
iR
qA
in
XK
xP
rr
qA
if
nB
iR
iR
iR
iR
iR
iR
"}
(21,1,1) = {"
iR
iR
XK
fy
XK
Lx
AG
XV
XK
in
qA
mj
iR
iR
iR
iR
rU
iR
iR
iR
iR
iR
iR
iR
iR
iR
iR
Nq
iR
iR
"}
(22,1,1) = {"
iR
iR
in
XK
XK
XK
XK
XK
in
in
ew
iR
iR
iR
iR
iR
iR
iR
iR
iR
Nq
iL
iR
iR
CM
To
Nq
wj
Nq
iR
"}
(23,1,1) = {"
iR
iR
lA
qA
qA
IP
XV
gp
qA
sF
iR
iR
iR
iR
iR
iR
iR
iR
iR
wj
Nq
CM
iR
nB
CM
tc
oB
To
iR
iR
"}
(24,1,1) = {"
iR
iR
iR
lA
in
in
in
in
CZ
iR
iR
iR
mu
iR
iR
iR
iR
iR
si
Nq
CM
CM
CM
iR
CM
rp
oB
To
vl
iR
"}
(25,1,1) = {"
iR
iR
iR
iR
lA
xP
iv
Ly
iR
iR
iR
aH
Nq
aH
iR
iR
iR
CM
CM
CM
CM
CM
CM
CM
CM
CM
To
To
Nq
iR
"}
(26,1,1) = {"
iR
iR
iR
iR
iR
iR
iR
iR
iR
iR
Nq
vl
Nq
Nq
Nq
CM
NC
NC
CM
CM
CM
CM
CM
CM
CM
To
Nq
iR
iR
iR
"}
(27,1,1) = {"
iR
iR
iR
iR
iR
iR
iR
iR
iR
iR
CM
Nq
WI
Nq
CM
NC
NC
NC
mJ
NC
CM
CM
iR
iR
Nq
Nq
Nq
AF
iR
iR
"}
(28,1,1) = {"
iR
iR
iR
iR
iR
iR
iR
iR
iR
iR
CM
CM
CM
CM
CM
NC
hQ
iR
iR
NC
mJ
iR
iR
iR
Nq
vl
iR
iR
iR
iR
"}
(29,1,1) = {"
iR
iR
iR
iR
iR
iR
iR
iR
iR
iR
iR
CM
CM
NC
NC
NC
hQ
iR
iR
Vc
hQ
NC
CM
Nq
Nq
iR
iR
iR
iR
iR
"}
(30,1,1) = {"
iR
iR
iR
iR
iR
iR
iR
iR
iR
iR
iR
iR
iR
NC
jc
NC
iR
iR
iR
iR
iR
iR
iR
iR
iR
iR
iR
iR
iR
iR
"}

(1,1,2) = {"
iR
iR
iR
iR
iR
iR
iR
iR
iR
iR
iR
iR
iR
aH
aH
aH
iR
iR
iR
iR
iR
iR
iR
iR
iR
iR
iR
iR
iR
iR
"}
(2,1,2) = {"
iR
iR
iR
iR
iR
iR
iR
iR
iR
iR
iR
iR
aG
aH
aH
aH
aH
aX
aX
To
Bh
Bh
Nq
Nq
Nq
GC
GC
GC
iR
iR
"}
(3,1,2) = {"
iR
iR
iR
gT
vg
Dz
Pt
iR
iR
iR
iR
iR
iR
aH
aH
aH
aX
aX
To
To
CM
OL
Fy
CI
iR
iR
GC
GC
GC
iR
"}
(4,1,2) = {"
iR
iR
iR
Pt
Co
vg
Co
eL
mu
iR
iR
mu
aH
aH
aH
aH
aX
aX
aX
aX
To
To
To
SP
CM
iR
iR
GC
Cj
iR
"}
(5,1,2) = {"
iR
iR
iR
iR
bo
MV
aH
aH
mu
iR
iR
iR
aH
Nr
aH
aX
aX
aX
aX
aX
aX
aX
CM
CM
CM
Nq
iR
iR
EP
iR
"}
(6,1,2) = {"
iR
iR
iR
iR
aH
Co
vd
aH
iR
iR
iR
mu
aH
iR
CM
aX
aX
aX
aX
aX
aX
aX
aH
CM
CM
CM
Nq
iR
iR
iR
"}
(7,1,2) = {"
iR
iR
iR
iR
vd
aH
iR
aH
iR
iR
iR
iR
aH
To
CM
iR
iR
aX
aX
aX
aX
Sk
pr
pr
pr
To
Nq
Nq
iR
iR
"}
(8,1,2) = {"
iR
iR
iR
aH
QX
iR
aH
aH
iR
iR
iR
iR
iR
iR
To
iR
iR
aX
aX
aX
aX
Sk
pr
pr
pr
To
aG
iR
iR
iR
"}
(9,1,2) = {"
iR
iR
iR
iR
iR
iR
yN
iR
iR
iR
iR
iR
iR
iR
aH
iR
iR
iR
aX
aX
iR
iR
iR
pr
pr
aH
To
aH
iR
iR
"}
(10,1,2) = {"
iR
iR
iR
iR
iR
iR
yN
iR
iR
iR
iR
aX
aX
aX
aH
iR
iR
iR
iR
iR
iR
iR
iR
pr
pr
aH
iR
iR
iR
iR
"}
(11,1,2) = {"
iR
iR
iR
iR
iR
mu
vf
iR
aX
aX
aX
aX
aX
aX
aH
iR
iR
iR
iR
iR
iR
iR
iR
pr
pr
aH
mu
iR
iR
iR
"}
(12,1,2) = {"
vg
iR
iR
iR
aH
aH
vg
iR
aX
aX
aX
aX
aX
aX
aH
aH
iR
iR
iR
iR
iR
iR
pr
pr
pr
aH
aH
aH
iR
iR
"}
(13,1,2) = {"
aH
aH
CM
CM
CM
aH
aH
aH
aH
aX
aX
aX
aX
aX
aX
aH
iR
iR
aX
aX
aX
aX
pr
pr
pr
aX
iR
aH
iR
iR
"}
(14,1,2) = {"
aH
CM
CM
CM
CM
CM
CM
aH
aH
aX
aH
aH
aX
aX
vg
aH
iR
aX
aX
aX
aX
aX
pr
pr
pr
aX
aX
aH
aH
aH
"}
(15,1,2) = {"
CM
CM
To
To
kh
CM
iR
iR
aX
aX
aX
Xc
aX
aX
aX
iR
iR
aX
aX
aX
aX
aX
pr
pr
pr
aX
aX
aX
aH
aH
"}
(16,1,2) = {"
To
To
To
iR
iR
iR
iR
iR
aX
aX
aX
iR
iR
aX
iR
iR
aX
aX
aX
aX
aX
aX
pr
pr
pr
aX
aX
aX
aX
aH
"}
(17,1,2) = {"
To
CM
CM
iR
iR
iR
vg
aH
aH
aH
aX
iR
iR
iR
iR
iR
aX
aX
aX
aX
aX
aX
pr
pr
pr
aX
aX
aX
aH
aH
"}
(18,1,2) = {"
iR
iR
CM
CM
CM
CM
To
To
aH
ah
iR
iR
iR
iR
iR
iR
iR
aX
aX
aX
aX
aX
pr
pr
pr
aX
aX
aH
aH
iR
"}
(19,1,2) = {"
iR
iR
iR
iR
iR
CM
CM
To
To
iR
iR
iR
iR
iR
iR
iR
iR
iR
iR
aX
aX
aX
pr
pr
pr
iR
iR
iR
iR
iR
"}
(20,1,2) = {"
iR
iR
iR
iR
iR
aH
CM
fm
iR
iR
iR
iR
aG
iR
gT
vg
iR
iR
iR
iR
iR
iR
pr
pr
pr
iR
iR
iR
iR
iR
"}
(21,1,2) = {"
iR
iR
iR
aH
aH
aH
xc
iR
iR
iR
aH
dr
aH
iR
iR
AQ
iR
iR
iR
iR
iR
iR
pr
pr
iR
iR
iR
iR
iR
iR
"}
(22,1,2) = {"
iR
BF
aH
aH
iR
iR
iR
iR
iR
iR
aH
iR
aH
IB
iR
aH
iR
iR
iR
iR
aX
aX
pr
pr
iR
iR
iR
iR
iR
iR
"}
(23,1,2) = {"
iR
aH
aH
iR
iR
iR
IB
iR
iR
iR
aH
iR
aH
iR
iR
Eq
aH
iR
iR
aX
aX
aX
pr
pr
pr
oB
aX
iR
iR
iR
"}
(24,1,2) = {"
iR
aH
iR
iR
iR
iR
aH
iR
eK
aH
aG
iR
mN
aH
iR
iR
aH
iR
iR
aX
aX
aX
pr
pr
pr
oB
aX
aX
iR
iR
"}
(25,1,2) = {"
iR
aH
aH
aH
aH
aG
aH
iR
aH
iR
iR
iR
iR
aG
iR
iR
aH
iR
iR
iR
aX
aX
aX
aX
aX
aX
aX
aX
iR
iR
"}
(26,1,2) = {"
iR
aH
iR
iR
iR
aH
iR
iR
aH
aH
aH
aH
aH
aH
aH
iR
aH
iR
iR
aX
aX
aX
aX
aX
aX
aX
aX
iR
iR
iR
"}
(27,1,2) = {"
iR
aH
iR
iR
iR
aH
tW
aH
zU
AQ
iR
iR
aH
vg
aH
aH
aH
iR
iR
iR
aX
aX
aH
aH
aX
iR
iR
iR
iR
iR
"}
(28,1,2) = {"
iR
aH
aH
aH
iR
aH
iR
iR
iR
iR
iR
iR
iR
iR
iR
aH
aH
Cq
iR
iR
aX
Ei
aH
DH
iR
iR
iR
iR
iR
iR
"}
(29,1,2) = {"
iR
iR
iR
aG
vg
aH
iR
iR
iR
iR
iR
iR
iR
iR
iR
aH
aH
vg
iR
iR
iR
MX
bd
iR
iR
iR
iR
iR
iR
iR
"}
(30,1,2) = {"
iR
iR
iR
iR
iR
iR
iR
iR
iR
iR
iR
iR
iR
iR
aH
aH
aH
iR
iR
iR
iR
iR
iR
iR
iR
iR
iR
iR
iR
iR
"}
