//MAP CONVERTED BY dmm2tgm.py THIS HEADER COMMENT PREVENTS RECONVERSION, DO NOT REMOVE
"aa" = (
/turf/closed/mineral/rogue/bedrock,
/area/rogue/under/tomb/cave/wet)
"ab" = (
/turf/open/floor/rogue/tile/masonic/spiral,
/area/rogue/under/tomb/indoors/magic)
"ac" = (
/obj/effect/dungeon_directional_helper/south,
/turf/open/floor/rogue/tile/masonic/spiral,
/area/rogue/under/tomb/indoors/magic)
"ad" = (
/obj/structure/table/wood,
/obj/effect/spawner/lootdrop/cheap_tableware_spawner,
/obj/effect/spawner/lootdrop/cheap_candle_spawner,
/obj/effect/spawner/lootdrop/valuable_jewelry_spawner,
/obj/effect/spawner/lootdrop/valuable_jewelry_spawner,
/turf/open/floor/rogue/tile/masonic/spiral,
/area/rogue/under/tomb/indoors/magic)
"ae" = (
/turf/open/transparent/openspace,
/area/rogue/under/tomb/indoors/magic)

(1,1,1) = {"
aa
aa
aa
"}
(2,1,1) = {"
ad
ab
ac
"}
(3,1,1) = {"
aa
aa
aa
"}

(1,1,2) = {"
aa
aa
aa
"}
(2,1,2) = {"
ae
ae
ae
"}
(3,1,2) = {"
aa
aa
aa
"}
