//MAP CONVERTED BY dmm2tgm.py THIS HEADER COMMENT PREVENTS RECONVERSION, DO NOT REMOVE
"aa" = (
/turf/closed/mineral/rogue/bedrock,
/area/rogue/under/tomb/cave/wet)
"ac" = (
/turf/open/floor/rogue/tile/masonic/spiral,
/area/rogue/under/tomb/indoors/magic)
"ad" = (
/obj/effect/dungeon_directional_helper/north,
/turf/open/floor/rogue/tile/masonic/spiral,
/area/rogue/under/tomb/indoors/magic)
"ae" = (
/obj/structure/table/wood,
/obj/effect/spawner/lootdrop/valuable_jewelry_spawner,
/obj/effect/spawner/lootdrop/valuable_candle_spawner,
/obj/effect/spawner/lootdrop/valuable_jewelry_spawner,
/turf/open/floor/rogue/tile/masonic/spiral,
/area/rogue/under/tomb/indoors/magic)
"af" = (
/turf/open/transparent/openspace,
/area/rogue/under/tomb/indoors/magic)

(1,1,1) = {"
aa
aa
aa
"}
(2,1,1) = {"
ad
ac
ae
"}
(3,1,1) = {"
aa
aa
aa
"}

(1,1,2) = {"
aa
aa
aa
"}
(2,1,2) = {"
af
af
af
"}
(3,1,2) = {"
aa
aa
aa
"}
