//MAP CONVERTED BY dmm2tgm.py THIS HEADER COMMENT PREVENTS RECONVERSION, DO NOT REMOVE
"a" = (
/turf/open/transparent/openspace,
/area/rogue/under/tomb/cave/lava)
"b" = (
/turf/closed/mineral/rogue,
/area/rogue/under/tomb/cave/lava)
"c" = (
/obj/structure/flora/roguetree/burnt,
/turf/open/floor/rogue/dirt,
/area/rogue/under/tomb/cave/lava)
"d" = (
/obj/structure/flora/roguetree/burnt,
/turf/open/transparent/openspace,
/area/rogue/under/tomb/cave/lava)
"f" = (
/mob/living/carbon/human/species/goblin/npc/hell,
/obj/effect/mapping_helpers/floor_clothing_equipper,
/obj/item/clothing/under/roguetown/trou/leathertights,
/obj/item/clothing/wrists/roguetown/bracers/leather,
/obj/item/rogueweapon/pick/militia,
/turf/open/floor/rogue/cobble,
/area/rogue/under/tomb/cave/lava)
"g" = (
/turf/open/floor/rogue/cobble,
/area/rogue/under/tomb/cave/lava)
"j" = (
/obj/effect/dungeon_directional_helper/east,
/turf/open/floor/rogue/cobblerock,
/area/rogue/under/tomb/cave/lava)
"k" = (
/mob/living/carbon/human/species/goblin/npc/ambush/hell,
/turf/open/floor/rogue/dirt,
/area/rogue/under/tomb/cave/lava)
"l" = (
/mob/living/carbon/human/species/goblin/npc/ambush/hell,
/turf/open/floor/rogue/cobble,
/area/rogue/under/tomb/cave/lava)
"m" = (
/obj/structure/fluff/railing/wood,
/turf/open/floor/rogue/cobble,
/area/rogue/under/tomb/cave/lava)
"n" = (
/obj/machinery/light/rogue/forge,
/turf/open/floor/rogue/cobblerock,
/area/rogue/under/tomb/cave/lava)
"o" = (
/obj/structure/fluff/railing/wood{
	dir = 4
	},
/obj/structure/fluff/railing/wood{
	dir = 1;
	layer = 2.7;
	pixel_x = 2;
	pixel_y = 7
	},
/turf/open/floor/rogue/cobble,
/area/rogue/under/tomb/cave/lava)
"p" = (
/turf/open/lava,
/area/rogue/under/tomb/cave/lava)
"q" = (
/obj/effect/dungeon_directional_helper/north,
/turf/open/floor/rogue/cobblerock,
/area/rogue/under/tomb/cave/lava)
"r" = (
/obj/structure/fluff/railing/wood{
	dir = 8;
	pixel_y = -1
	},
/mob/living/carbon/human/species/goblin/npc/ambush/hell,
/turf/open/floor/rogue/cobble,
/area/rogue/under/tomb/cave/lava)
"u" = (
/obj/structure/fluff/grindwheel,
/turf/open/floor/rogue/cobblerock,
/area/rogue/under/tomb/cave/lava)
"v" = (
/obj/structure/fluff/railing/wood{
	dir = 8;
	pixel_y = -1
	},
/obj/structure/fluff/railing/wood,
/turf/open/floor/rogue/cobble,
/area/rogue/under/tomb/cave/lava)
"w" = (
/mob/living/carbon/human/species/goblin/npc/hell,
/obj/effect/mapping_helpers/floor_clothing_equipper,
/obj/item/clothing/under/roguetown/trou/leathertights,
/obj/item/clothing/wrists/roguetown/bracers/leather,
/obj/item/rogueweapon/stoneaxe/battle,
/turf/open/floor/rogue/cobble,
/area/rogue/under/tomb/cave/lava)
"x" = (
/turf/open/floor/rogue/cobblerock,
/area/rogue/under/tomb/cave/lava)
"y" = (
/obj/structure/fluff/railing/wood{
	dir = 4
	},
/obj/structure/fluff/railing/wood{
	dir = 1
	},
/turf/open/floor/rogue/cobble,
/area/rogue/under/tomb/cave/lava)
"z" = (
/obj/structure/fluff/railing/wood{
	dir = 4
	},
/turf/open/floor/rogue/cobble,
/area/rogue/under/tomb/cave/lava)
"A" = (
/obj/machinery/light/rogue/smelter,
/turf/open/floor/rogue/cobblerock,
/area/rogue/under/tomb/cave/lava)
"C" = (
/obj/structure/fluff/railing/wood,
/mob/living/carbon/human/species/goblin/npc/ambush/hell,
/turf/open/floor/rogue/cobble,
/area/rogue/under/tomb/cave/lava)
"E" = (
/mob/living/carbon/human/species/orc/npc/marauder,
/obj/structure/fluff/railing/wood{
	dir = 4
	},
/turf/open/floor/rogue/cobble,
/area/rogue/under/tomb/cave/lava)
"F" = (
/mob/living/carbon/human/species/goblin/npc/ambush/hell,
/turf/open/floor/rogue/cobblerock,
/area/rogue/under/tomb/cave/lava)
"G" = (
/obj/structure/fluff/railing/wood{
	dir = 8;
	pixel_y = -1
	},
/turf/open/floor/rogue/cobble,
/area/rogue/under/tomb/cave/lava)
"H" = (
/mob/living/carbon/human/species/orc/npc/marauder,
/turf/open/floor/rogue/cobble,
/area/rogue/under/tomb/cave/lava)
"I" = (
/obj/structure/fluff/railing/wood{
	dir = 4
	},
/mob/living/carbon/human/species/orc/npc/marauder,
/turf/open/floor/rogue/cobble,
/area/rogue/under/tomb/cave/lava)
"J" = (
/obj/structure/fluff/railing/wood{
	dir = 8;
	pixel_y = -1
	},
/obj/structure/fluff/railing/wood{
	dir = 1
	},
/turf/open/floor/rogue/cobble,
/area/rogue/under/tomb/cave/lava)
"K" = (
/obj/item/roguebin/water,
/turf/open/floor/rogue/cobblerock,
/area/rogue/under/tomb/cave/lava)
"L" = (
/obj/effect/dungeon_directional_helper/south,
/turf/open/floor/rogue/cobblerock,
/area/rogue/under/tomb/cave/lava)
"M" = (
/obj/machinery/anvil,
/obj/item/rogueweapon/hammer/steel{
	pixel_x = -6;
	pixel_y = 5
	},
/obj/effect/spawner/lootdrop/random_gem,
/obj/effect/spawner/lootdrop/random_gem,
/turf/open/floor/rogue/dirt,
/area/rogue/under/tomb/cave/lava)
"N" = (
/turf/open/floor/rogue/dirt,
/area/rogue/under/tomb/cave/lava)
"P" = (
/obj/structure/fluff/railing/wood{
	dir = 1;
	layer = 2.7;
	pixel_x = 2;
	pixel_y = 7
	},
/turf/open/floor/rogue/cobble,
/area/rogue/under/tomb/cave/lava)
"R" = (
/obj/effect/dungeon_directional_helper/west,
/turf/open/floor/rogue/cobblerock,
/area/rogue/under/tomb/cave/lava)
"S" = (
/obj/structure/fluff/railing/wood{
	dir = 1
	},
/turf/open/floor/rogue/cobble,
/area/rogue/under/tomb/cave/lava)
"T" = (
/obj/structure/fluff/railing/wood{
	dir = 8;
	pixel_y = -1
	},
/obj/structure/fluff/railing/wood{
	dir = 1;
	layer = 2.7;
	pixel_x = 2;
	pixel_y = 7
	},
/turf/open/floor/rogue/cobble,
/area/rogue/under/tomb/cave/lava)
"U" = (
/mob/living/carbon/human/species/orc/npc/berserker,
/turf/open/floor/rogue/cobble,
/area/rogue/under/tomb/cave/lava)
"V" = (
/obj/structure/fluff/railing/wood{
	dir = 4
	},
/obj/structure/fluff/railing/wood,
/turf/open/floor/rogue/cobble,
/area/rogue/under/tomb/cave/lava)
"W" = (
/obj/structure/fluff/railing/wood{
	dir = 1;
	layer = 2.7;
	pixel_x = 2;
	pixel_y = 7
	},
/obj/structure/fluff/railing/wood{
	dir = 4
	},
/turf/open/floor/rogue/cobble,
/area/rogue/under/tomb/cave/lava)
"Y" = (
/turf/closed/mineral/rogue/bedrock,
/area/rogue/under/tomb/cave/lava)
"Z" = (
/obj/structure/fluff/railing/wood,
/mob/living/carbon/human/species/orc/npc/marauder,
/turf/open/floor/rogue/cobble,
/area/rogue/under/tomb/cave/lava)

(1,1,1) = {"
Y
Y
Y
Y
Y
Y
Y
Y
Y
Y
Y
Y
Y
Y
x
x
R
x
Y
Y
Y
Y
Y
Y
Y
Y
Y
Y
Y
Y
"}
(2,1,1) = {"
Y
Y
Y
Y
Y
Y
x
N
N
N
N
N
x
x
x
x
x
N
N
x
x
x
x
N
Y
Y
Y
Y
Y
Y
"}
(3,1,1) = {"
Y
Y
Y
Y
x
x
N
k
N
N
N
N
N
N
N
N
k
N
N
N
x
x
N
c
N
Y
Y
Y
Y
Y
"}
(4,1,1) = {"
Y
Y
Y
Y
x
N
N
N
N
p
p
N
N
N
x
x
x
x
N
N
N
N
N
N
N
Y
Y
Y
Y
Y
"}
(5,1,1) = {"
Y
Y
Y
x
N
N
N
p
p
p
p
p
p
x
x
x
x
N
N
p
p
p
p
N
N
x
Y
Y
Y
Y
"}
(6,1,1) = {"
Y
Y
N
N
N
p
p
p
p
p
p
p
p
p
p
p
p
p
p
p
p
p
p
p
N
x
x
Y
Y
Y
"}
(7,1,1) = {"
Y
N
N
N
p
p
p
p
p
p
p
p
p
p
p
p
p
p
p
p
p
p
p
p
p
N
x
x
Y
Y
"}
(8,1,1) = {"
Y
N
N
p
p
p
p
b
p
p
p
p
p
p
p
p
p
p
p
p
p
b
p
p
p
N
N
x
x
Y
"}
(9,1,1) = {"
Y
N
N
p
p
p
p
p
N
N
N
p
p
p
p
p
p
p
p
p
N
N
p
p
p
p
N
c
x
Y
"}
(10,1,1) = {"
Y
N
N
p
p
p
p
x
x
x
p
p
p
p
p
p
p
p
p
x
x
N
p
p
p
p
N
N
x
Y
"}
(11,1,1) = {"
Y
N
N
p
p
p
x
N
N
N
p
p
p
p
p
p
p
p
N
x
x
N
p
p
p
p
N
N
N
Y
"}
(12,1,1) = {"
Y
x
N
p
p
p
x
x
x
p
p
p
p
x
u
x
p
p
p
N
N
p
p
p
p
p
N
N
k
Y
"}
(13,1,1) = {"
Y
F
N
N
p
p
p
p
p
p
p
N
N
x
N
F
x
x
p
p
p
p
p
p
p
N
N
N
x
Y
"}
(14,1,1) = {"
x
x
N
N
p
p
p
p
p
p
p
N
u
x
N
N
A
N
p
p
p
p
p
p
p
N
N
x
x
x
"}
(15,1,1) = {"
q
x
N
N
p
p
p
p
p
p
p
x
K
k
M
x
x
N
p
p
p
p
p
p
p
N
N
x
x
x
"}
(16,1,1) = {"
x
x
N
x
p
p
p
p
p
p
p
p
n
x
N
x
A
N
p
p
p
p
p
p
p
N
N
N
x
L
"}
(17,1,1) = {"
x
N
N
x
p
p
p
p
p
p
p
p
p
x
x
x
N
x
p
p
p
p
p
p
p
p
N
N
N
N
"}
(18,1,1) = {"
Y
N
N
x
p
p
p
p
p
p
p
p
p
p
x
x
p
p
p
p
p
p
p
p
p
p
N
N
N
Y
"}
(19,1,1) = {"
Y
x
N
x
p
p
p
p
x
x
p
p
p
p
p
p
p
p
p
p
p
p
p
p
p
p
N
N
N
Y
"}
(20,1,1) = {"
Y
x
N
N
N
p
p
p
x
N
x
N
p
p
p
p
p
N
N
p
p
p
p
p
p
p
p
N
N
Y
"}
(21,1,1) = {"
Y
N
N
N
N
p
p
b
p
N
x
N
p
p
p
p
x
x
x
x
p
b
p
p
p
p
p
N
N
Y
"}
(22,1,1) = {"
Y
Y
N
N
N
N
p
p
p
p
N
N
p
p
p
p
x
x
N
p
p
p
p
p
p
p
N
N
x
Y
"}
(23,1,1) = {"
Y
Y
N
N
c
N
p
p
p
p
p
p
p
p
p
p
p
p
p
p
p
p
p
p
p
N
x
x
Y
Y
"}
(24,1,1) = {"
Y
Y
N
N
N
N
p
p
p
p
p
p
p
p
p
p
p
p
p
p
p
p
p
p
N
x
x
Y
Y
Y
"}
(25,1,1) = {"
Y
Y
Y
N
N
N
N
p
p
p
p
p
p
p
p
p
p
p
p
p
p
p
p
N
N
x
Y
Y
Y
Y
"}
(26,1,1) = {"
Y
Y
Y
Y
N
N
N
N
x
p
p
p
p
p
p
p
p
p
p
p
N
N
N
N
N
N
Y
Y
Y
Y
"}
(27,1,1) = {"
Y
Y
Y
Y
Y
Y
N
x
x
x
x
N
N
p
p
p
p
p
N
N
N
N
c
N
Y
Y
Y
Y
Y
Y
"}
(28,1,1) = {"
Y
Y
Y
Y
Y
Y
Y
Y
x
x
N
N
N
N
N
N
x
x
N
N
N
N
N
Y
Y
Y
Y
Y
Y
Y
"}
(29,1,1) = {"
Y
Y
Y
Y
Y
Y
Y
Y
Y
Y
N
N
N
N
N
x
F
x
x
x
Y
Y
Y
Y
Y
Y
Y
Y
Y
Y
"}
(30,1,1) = {"
Y
Y
Y
Y
Y
Y
Y
Y
Y
Y
Y
Y
Y
Y
Y
N
x
j
x
Y
Y
Y
Y
Y
Y
Y
Y
Y
Y
Y
"}

(1,1,2) = {"
Y
Y
Y
Y
Y
Y
Y
Y
Y
Y
Y
Y
Y
Y
g
g
g
g
Y
Y
Y
Y
Y
Y
Y
Y
Y
Y
Y
Y
"}
(2,1,2) = {"
Y
Y
Y
Y
Y
Y
a
a
a
a
a
a
a
a
g
g
g
g
a
a
a
a
a
a
Y
Y
Y
Y
Y
Y
"}
(3,1,2) = {"
Y
Y
Y
Y
a
a
a
a
a
a
a
a
a
a
a
P
m
a
a
a
a
a
a
a
a
Y
Y
Y
Y
Y
"}
(4,1,2) = {"
Y
Y
Y
Y
a
a
a
a
a
a
a
a
a
a
a
P
m
a
a
a
a
a
a
a
a
Y
Y
Y
Y
Y
"}
(5,1,2) = {"
Y
Y
Y
a
a
a
a
a
a
a
a
a
a
a
a
P
m
a
a
a
a
a
a
a
a
a
Y
Y
Y
Y
"}
(6,1,2) = {"
Y
Y
a
a
a
a
a
a
a
a
a
a
a
a
T
w
g
v
a
a
a
a
a
a
a
a
a
Y
Y
Y
"}
(7,1,2) = {"
Y
a
a
a
a
a
a
T
G
G
G
G
G
G
g
g
g
g
G
G
G
v
a
a
a
a
a
a
Y
Y
"}
(8,1,2) = {"
Y
a
a
a
a
a
T
l
g
z
z
z
z
z
z
z
E
z
z
z
g
g
v
a
a
a
a
a
a
Y
"}
(9,1,2) = {"
Y
a
a
a
a
a
P
g
V
a
a
a
a
a
a
a
a
a
a
a
y
g
m
a
a
a
a
a
a
Y
"}
(10,1,2) = {"
Y
a
a
a
a
a
P
m
a
a
a
a
a
a
a
a
a
a
a
a
a
S
m
a
a
a
a
a
a
Y
"}
(11,1,2) = {"
Y
a
a
a
a
a
P
m
a
a
a
a
a
a
a
a
a
a
a
a
a
S
m
a
a
a
a
a
a
Y
"}
(12,1,2) = {"
Y
a
a
a
a
a
P
m
a
a
a
a
a
a
a
a
a
a
a
a
a
S
m
a
a
a
a
a
a
Y
"}
(13,1,2) = {"
Y
a
a
a
a
a
P
m
a
a
a
a
a
a
a
a
a
a
a
a
a
S
C
a
a
a
a
a
a
Y
"}
(14,1,2) = {"
g
g
a
a
a
T
g
m
a
a
a
a
a
a
a
a
a
a
a
a
a
S
g
v
a
a
a
a
g
g
"}
(15,1,2) = {"
g
g
G
r
G
H
g
m
a
a
a
a
a
a
a
a
a
a
a
a
a
S
g
g
G
G
G
g
l
g
"}
(16,1,2) = {"
g
g
z
z
z
g
f
m
a
a
a
a
a
a
a
a
a
a
a
a
a
S
w
g
I
z
z
g
g
g
"}
(17,1,2) = {"
g
g
a
a
a
W
g
m
a
a
a
a
a
a
a
a
a
a
a
a
a
S
g
V
a
a
a
a
g
g
"}
(18,1,2) = {"
Y
a
a
a
a
a
P
m
a
a
a
a
a
a
a
a
a
a
a
a
a
S
m
a
a
a
a
a
a
Y
"}
(19,1,2) = {"
Y
a
a
a
a
a
P
m
a
a
a
a
a
a
a
a
a
a
a
a
a
S
m
a
a
a
a
a
a
Y
"}
(20,1,2) = {"
Y
a
a
a
a
a
P
U
v
a
a
a
a
a
a
a
a
a
a
a
J
g
m
a
a
a
a
a
a
Y
"}
(21,1,2) = {"
Y
a
a
a
a
a
W
g
g
G
G
G
G
G
G
G
G
G
G
G
g
g
V
a
a
a
a
a
a
Y
"}
(22,1,2) = {"
Y
Y
a
a
a
a
a
o
z
z
z
z
z
z
z
g
l
g
g
z
z
V
a
a
a
a
a
a
a
Y
"}
(23,1,2) = {"
Y
Y
a
a
a
a
a
a
a
a
a
a
a
a
a
y
g
g
V
a
a
a
a
a
a
a
a
a
Y
Y
"}
(24,1,2) = {"
Y
Y
a
a
a
a
a
a
a
a
a
a
a
a
a
a
S
m
a
a
a
a
a
a
a
a
a
Y
Y
Y
"}
(25,1,2) = {"
Y
Y
Y
a
a
a
a
a
a
a
a
a
a
a
a
a
S
m
a
a
a
a
a
a
a
a
Y
Y
Y
Y
"}
(26,1,2) = {"
Y
Y
Y
Y
a
a
a
a
a
a
a
a
a
a
a
a
S
Z
a
a
a
a
a
a
a
a
Y
Y
Y
Y
"}
(27,1,2) = {"
Y
Y
Y
Y
Y
Y
a
a
a
a
a
a
a
a
a
a
S
m
a
a
a
a
d
a
Y
Y
Y
Y
Y
Y
"}
(28,1,2) = {"
Y
Y
Y
Y
Y
Y
Y
Y
a
a
a
a
a
a
a
a
g
g
a
a
a
a
a
Y
Y
Y
Y
Y
Y
Y
"}
(29,1,2) = {"
Y
Y
Y
Y
Y
Y
Y
Y
Y
Y
a
a
a
a
a
g
l
g
g
a
Y
Y
Y
Y
Y
Y
Y
Y
Y
Y
"}
(30,1,2) = {"
Y
Y
Y
Y
Y
Y
Y
Y
Y
Y
Y
Y
Y
Y
Y
g
g
g
g
Y
Y
Y
Y
Y
Y
Y
Y
Y
Y
Y
"}
