//MAP CONVERTED BY dmm2tgm.py THIS HEADER COMMENT PREVENTS RECONVERSION, DO NOT REMOVE
"al" = (
/obj/machinery/light/rogue/torchholder/l,
/turf/open/floor/rogue/dirt/road,
/area/rogue/under/tomb/wilds/bog)
"bh" = (
/obj/machinery/light/rogue/candle/l,
/turf/open/floor/rogue/tile/checkeralt,
/area/rogue/under/tomb/indoors/royal)
"bE" = (
/obj/machinery/light/rogue/torchholder/c,
/turf/open/floor/rogue/dirt/road,
/area/rogue/under/tomb/wilds/bog)
"cq" = (
/obj/structure/table/wood/fancy/royalblack,
/obj/structure/closet/crate/chest/gold,
/obj/effect/spawner/lootdrop/valuable_clutter_spawner,
/turf/open/floor/rogue/carpet,
/area/rogue/under/tomb/indoors/royal)
"cr" = (
/turf/closed/mineral/rogue/bedrock,
/area/rogue/under/tomb/wilds/bog)
"cO" = (
/obj/machinery/light/rogue/torchholder/c,
/obj/structure/flora/roguegrass/swampweed,
/turf/open/floor/rogue/dirt/ambush,
/area/rogue/under/tomb/wilds/bog)
"dG" = (
/turf/open/water/swamp/deep,
/area/rogue/under/tomb/wilds/bog)
"dV" = (
/obj/machinery/light/rogue/candle/l,
/obj/structure/fluff/statue/knight/interior,
/turf/open/floor/rogue/tile/checkeralt,
/area/rogue/under/tomb/indoors/royal)
"ey" = (
/obj/structure/table/wood,
/obj/item/rogueweapon/pitchfork/copper,
/obj/item/reagent_containers/glass/cup/wooden,
/obj/item/clothing/mask/cigarette/pipe/crafted,
/obj/item/reagent_containers/food/snacks/grown/rogue/swampweeddry,
/turf/open/floor/rogue/blocks/paving/vert,
/area/rogue/under/tomb/indoors)
"fj" = (
/obj/structure/fluff/walldeco/painting/seraphina{
	pixel_x = 3;
	pixel_y = -32
	},
/turf/open/floor/rogue/tile/checkeralt,
/area/rogue/under/tomb/indoors/royal)
"gk" = (
/turf/open/floor/rogue/carpet,
/area/rogue/under/tomb/indoors/royal)
"gl" = (
/mob/living/simple_animal/hostile/retaliate/rogue/minotaur/axe,
/turf/open/floor/rogue/carpet,
/area/rogue/under/tomb/indoors/royal)
"iQ" = (
/obj/machinery/light/rogue/torchholder/r,
/turf/open/floor/rogue/dirt/ambush,
/area/rogue/under/tomb/wilds/bog)
"kc" = (
/obj/machinery/light/rogue/torchholder/r,
/obj/effect/landmark/chest_or_mimic,
/obj/item/reagent_containers/glass/bottle/rogue/healthpotnew,
/obj/item/reagent_containers/food/snacks/rogue/cheddar/aged,
/turf/open/floor/rogue/blocks/paving/vert,
/area/rogue/under/tomb/indoors)
"lX" = (
/obj/machinery/light/rogue/torchholder/c,
/turf/closed/mineral/rogue/bedrock,
/area/rogue/under/tomb/wilds/bog)
"mh" = (
/obj/structure/bed/rogue/shit,
/turf/open/floor/rogue/blocks/paving/vert,
/area/rogue/under/tomb/indoors)
"mC" = (
/obj/structure/fluff/walldeco/rpainting/forest{
	pixel_x = 33;
	pixel_y = 0
	},
/turf/open/floor/rogue/tile/checkeralt,
/area/rogue/under/tomb/indoors/royal)
"nj" = (
/obj/structure/mineral_door/bars,
/turf/open/floor/rogue/blocks/paving/vert,
/area/rogue/under/tomb/indoors)
"nZ" = (
/mob/living/simple_animal/hostile/retaliate/rogue/trufflepig,
/turf/open/water/swamp/deep,
/area/rogue/under/tomb/wilds/bog)
"oU" = (
/turf/open/floor/rogue/blocks/paving/vert,
/area/rogue/under/tomb/indoors)
"pk" = (
/turf/open/floor/rogue/tile/checkeralt,
/area/rogue/under/tomb/indoors/royal)
"pC" = (
/obj/machinery/light/rogue/candle/r,
/turf/open/floor/rogue/tile/checkeralt,
/area/rogue/under/tomb/indoors/royal)
"pX" = (
/obj/structure/chair/stool/rogue,
/turf/open/floor/rogue/blocks/paving/vert,
/area/rogue/under/tomb/indoors)
"pZ" = (
/obj/machinery/light/rogue/torchholder/l,
/obj/structure/fermentation_keg/water,
/turf/open/floor/rogue/blocks/paving/vert,
/area/rogue/under/tomb/indoors)
"qh" = (
/obj/structure/fluff/walldeco/painting/skull{
	pixel_x = 1;
	pixel_y = -33
	},
/turf/open/floor/rogue/tile/checkeralt,
/area/rogue/under/tomb/indoors/royal)
"sS" = (
/mob/living/simple_animal/hostile/retaliate/rogue/minotaur/axe,
/turf/open/floor/rogue/tile/checkeralt,
/area/rogue/under/tomb/indoors/royal)
"th" = (
/obj/machinery/light/rogue/torchholder/c,
/turf/open/floor/rogue/dirt/ambush,
/area/rogue/under/tomb/wilds/bog)
"ty" = (
/obj/structure/fluff/statue/evil,
/turf/open/floor/rogue/tile/checkeralt,
/area/rogue/under/tomb/indoors/royal)
"tM" = (
/obj/machinery/light/rogue/torchholder/l,
/obj/structure/flora/roguegrass/swampweed,
/turf/open/floor/rogue/dirt/ambush,
/area/rogue/under/tomb/wilds/bog)
"vT" = (
/turf/open/water/swamp,
/area/rogue/under/tomb/wilds/bog)
"wj" = (
/obj/machinery/light/rogue/torchholder/r,
/turf/open/floor/rogue/dirt/road,
/area/rogue/under/tomb/wilds/bog)
"wo" = (
/obj/machinery/light/rogue/candle/r,
/obj/structure/fluff/statue/knight/interior/r,
/turf/open/floor/rogue/tile/checkeralt,
/area/rogue/under/tomb/indoors/royal)
"xu" = (
/obj/structure/table/wood/fancy/royalblack,
/obj/structure/closet/crate/chest/gold,
/obj/effect/spawner/lootdrop/valuable_tableware_spawner,
/turf/open/floor/rogue/carpet,
/area/rogue/under/tomb/indoors/royal)
"yt" = (
/obj/structure/fluff/walldeco/rpainting/crown{
	pixel_x = -32;
	pixel_y = 0
	},
/turf/open/floor/rogue/tile/checkeralt,
/area/rogue/under/tomb/indoors/royal)
"Bv" = (
/mob/living/simple_animal/hostile/retaliate/rogue/minotaur/axe/female,
/turf/open/floor/rogue/tile/checkeralt,
/area/rogue/under/tomb/indoors/royal)
"CP" = (
/turf/closed/wall/mineral/rogue/wood,
/area/rogue/under/tomb/indoors/royal)
"CX" = (
/obj/machinery/light/rogue/firebowl/standing,
/turf/open/floor/rogue/carpet,
/area/rogue/under/tomb/indoors/royal)
"Eu" = (
/obj/machinery/light/rogue/candle/r,
/turf/open/floor/rogue/carpet,
/area/rogue/under/tomb/indoors/royal)
"Hc" = (
/mob/living/simple_animal/hostile/retaliate/rogue/trufflepig,
/turf/open/floor/rogue/dirt/ambush,
/area/rogue/under/tomb/wilds/bog)
"HM" = (
/obj/structure/flora/roguegrass/swampweed,
/turf/open/floor/rogue/dirt/road,
/area/rogue/under/tomb/wilds/bog)
"If" = (
/obj/machinery/light/rogue/torchholder/c,
/obj/effect/dungeon_directional_helper/west,
/turf/open/floor/rogue/dirt/road,
/area/rogue/under/tomb/wilds/bog)
"Ik" = (
/obj/machinery/light/rogue/torchholder/c,
/mob/living/simple_animal/hostile/retaliate/rogue/trufflepig,
/turf/open/floor/rogue/dirt/ambush,
/area/rogue/under/tomb/wilds/bog)
"Lx" = (
/obj/machinery/light/rogue/candle/l,
/turf/open/floor/rogue/carpet,
/area/rogue/under/tomb/indoors/royal)
"Ly" = (
/obj/machinery/light/rogue/torchholder/c,
/obj/effect/dungeon_directional_helper/east,
/turf/open/floor/rogue/dirt/road,
/area/rogue/under/tomb/wilds/bog)
"Mq" = (
/obj/structure/flora/rogueshroom/happy/random,
/turf/closed/mineral/rogue/bedrock,
/area/rogue/under/tomb/wilds/bog)
"NI" = (
/turf/closed/mineral/rogue/bedrock,
/area/rogue/under/tomb/indoors)
"NT" = (
/obj/structure/flora/rogueshroom/happy/random,
/turf/open/floor/rogue/dirt/ambush,
/area/rogue/under/tomb/wilds/bog)
"NY" = (
/obj/structure/table/wood/fancy/royalblack,
/obj/structure/closet/crate/chest/gold,
/obj/effect/spawner/lootdrop/valuable_candle_spawner,
/turf/open/floor/rogue/carpet,
/area/rogue/under/tomb/indoors/royal)
"Oa" = (
/obj/structure/flora/roguegrass/swampweed,
/turf/open/floor/rogue/dirt/ambush,
/area/rogue/under/tomb/wilds/bog)
"Oc" = (
/obj/structure/table/wood/fancy/royalblack,
/obj/item/clothing/mask/rogue/facemask/goldmask,
/obj/item/storage/belt/rogue/leather/plaquegold,
/obj/structure/closet/crate/chest/gold,
/obj/item/reagent_containers/food/snacks/rogue/cheddar/aged,
/obj/item/reagent_containers/food/snacks/rogue/cheddar/aged,
/obj/item/lockpick,
/obj/item/lockpick,
/obj/item/lockpick,
/obj/item/lockpick,
/obj/item/lockpick,
/obj/item/lockpickring,
/obj/effect/spawner/lootdrop/valuable_jewelry_spawner,
/turf/open/floor/rogue/carpet,
/area/rogue/under/tomb/indoors/royal)
"Om" = (
/obj/structure/fluff/walldeco/painting/queen{
	pixel_x = 0;
	pixel_y = 32
	},
/turf/open/floor/rogue/tile/checkeralt,
/area/rogue/under/tomb/indoors/royal)
"RR" = (
/obj/effect/dungeon_directional_helper/south,
/turf/open/floor/rogue/dirt/road,
/area/rogue/under/tomb/wilds/bog)
"RW" = (
/turf/open/floor/rogue/dirt/ambush,
/area/rogue/under/tomb/wilds/bog)
"Tr" = (
/obj/structure/flora/rogueshroom/happy/random,
/turf/open/floor/rogue/dirt/road,
/area/rogue/under/tomb/wilds/bog)
"Vj" = (
/obj/effect/dungeon_directional_helper/north,
/turf/open/floor/rogue/dirt/road,
/area/rogue/under/tomb/wilds/bog)
"VK" = (
/mob/living/simple_animal/hostile/retaliate/rogue/trufflepig,
/turf/open/floor/rogue/dirt/road,
/area/rogue/under/tomb/wilds/bog)
"Wx" = (
/turf/open/floor/rogue/dirt/road,
/area/rogue/under/tomb/wilds/bog)
"Yd" = (
/obj/structure/mineral_door/wood/fancywood,
/turf/open/floor/rogue/carpet,
/area/rogue/under/tomb/indoors/royal)
"ZX" = (
/obj/structure/fluff/walldeco/painting{
	pixel_x = 0;
	pixel_y = 32
	},
/turf/open/floor/rogue/tile/checkeralt,
/area/rogue/under/tomb/indoors/royal)

(1,1,1) = {"
cr
cr
If
cr
cr
cr
cr
lX
cr
cr
lX
cr
cr
"}
(2,1,1) = {"
cr
Tr
RW
tM
cr
cr
Tr
Wx
cr
cr
RW
Wx
cr
"}
(3,1,1) = {"
cr
Ik
RW
Wx
Tr
cr
VK
Wx
Tr
cr
NT
Hc
cr
"}
(4,1,1) = {"
cr
Wx
Wx
Wx
Wx
cr
cr
RW
Oa
cr
HM
wj
cr
"}
(5,1,1) = {"
NI
NI
NI
vT
vT
vT
al
RW
cr
cr
RW
cr
cr
"}
(6,1,1) = {"
NI
mh
NI
NI
dG
cr
Tr
Wx
Wx
RW
RW
Wx
RR
"}
(7,1,1) = {"
NI
oU
pZ
NI
NI
cr
cr
Wx
cr
cr
cO
Wx
cr
"}
(8,1,1) = {"
NI
oU
oU
oU
nj
RW
Wx
RW
tM
cr
Tr
Wx
cr
"}
(9,1,1) = {"
NI
pX
ey
oU
NI
th
vT
vT
vT
cr
cr
Wx
cr
"}
(10,1,1) = {"
NI
kc
NI
NI
NI
Wx
cr
vT
Tr
cr
cr
bE
cr
"}
(11,1,1) = {"
NI
NI
NI
NT
RW
Wx
cr
vT
cr
cr
RW
VK
cr
"}
(12,1,1) = {"
Vj
Wx
Wx
RW
iQ
RW
cr
nZ
cr
RW
RW
Mq
cr
"}
(13,1,1) = {"
cr
lX
cr
cr
cr
cr
cr
cr
cr
Ly
cr
cr
cr
"}

(1,1,2) = {"
CP
CP
Yd
CP
CP
Yd
CP
CP
Yd
CP
CP
Yd
CP
"}
(2,1,2) = {"
Yd
Lx
gk
pk
dV
gk
bh
yt
gk
bh
pk
gk
CP
"}
(3,1,2) = {"
CP
pk
gk
gk
gk
gk
CX
gk
gk
gk
gk
gk
Yd
"}
(4,1,2) = {"
CP
Om
gk
pk
gk
pk
ty
pk
gk
pk
gk
pk
CP
"}
(5,1,2) = {"
Yd
gk
gk
gk
NY
gk
gk
gk
cq
gk
gk
pk
CP
"}
(6,1,2) = {"
CP
pk
gk
pk
gk
sS
gk
pk
gl
pk
gk
gk
Yd
"}
(7,1,2) = {"
CP
ZX
CX
ty
gk
gk
Oc
gk
gk
ty
CX
pk
CP
"}
(8,1,2) = {"
Yd
gk
gk
pk
gk
Bv
gk
sS
gk
pk
gk
fj
CP
"}
(9,1,2) = {"
CP
pk
gk
gk
xu
gk
gk
gk
NY
gk
gk
gk
Yd
"}
(10,1,2) = {"
CP
pk
gk
pk
gk
pk
ty
pk
gk
pk
gk
pk
CP
"}
(11,1,2) = {"
Yd
gk
gk
gk
gk
gk
CX
gk
gk
gk
gk
qh
CP
"}
(12,1,2) = {"
CP
gk
pC
pk
gk
pC
mC
gk
wo
pk
gk
Eu
Yd
"}
(13,1,2) = {"
CP
Yd
CP
CP
Yd
CP
CP
Yd
CP
CP
Yd
CP
CP
"}
