//MAP CONVERTED BY dmm2tgm.py THIS HEADER COMMENT PREVENTS RECONVERSION, DO NOT REMOVE
"a" = (
/turf/closed/mineral/rogue/bedrock,
/area/rogue/under/tomb)
"c" = (
/obj/item/clothing/suit/roguetown/armor/plate/cuirass/iron,
/turf/open/floor/rogue/naturalstone,
/area/rogue/under/tomb)
"e" = (
/obj/effect/dungeon_directional_helper/south,
/turf/open/floor/rogue/naturalstone,
/area/rogue/under/tomb)
"i" = (
/mob/living/carbon/human/species/skeleton,
/obj/effect/landmark/chest_or_mimic,
/turf/open/floor/rogue/naturalstone,
/area/rogue/under/tomb)
"k" = (
/obj/item/clothing/suit/roguetown/armor/chainmail/iron,
/turf/open/floor/rogue/naturalstone,
/area/rogue/under/tomb)
"l" = (
/obj/effect/landmark/chest_or_mimic,
/obj/item/clothing/head/roguetown/helmet/skullcap,
/turf/open/floor/rogue/naturalstone,
/area/rogue/under/tomb)
"m" = (
/obj/effect/landmark/chest_or_mimic,
/turf/open/floor/rogue/naturalstone,
/area/rogue/under/tomb)
"n" = (
/obj/effect/landmark/chest_or_mimic,
/obj/item/clothing/ring/silver,
/turf/open/floor/rogue/naturalstone,
/area/rogue/under/tomb)
"o" = (
/obj/item/clothing/head/roguetown/helmet/bascinet,
/turf/open/floor/rogue/naturalstone,
/area/rogue/under/tomb)
"p" = (
/obj/item/clothing/suit/roguetown/armor/plate/scale,
/obj/effect/spawner/lootdrop/roguetown/dungeon/weapons,
/turf/open/floor/rogue/naturalstone,
/area/rogue/under/tomb)
"q" = (
/obj/item/clothing/head/roguetown/helmet/winged,
/turf/open/floor/rogue/naturalstone,
/area/rogue/under/tomb)
"r" = (
/obj/item/clothing/suit/roguetown/armor/gambeson/lord,
/turf/open/floor/rogue/naturalstone,
/area/rogue/under/tomb)
"s" = (
/obj/effect/landmark/chest_or_mimic,
/obj/item/clothing/gloves/roguetown/plate,
/turf/open/floor/rogue/naturalstone,
/area/rogue/under/tomb)
"t" = (
/obj/structure/stairs/stone{
	dir = 1
	},
/turf/open/floor/rogue/naturalstone,
/area/rogue/under/tomb)
"u" = (
/obj/effect/dungeon_directional_helper/north,
/turf/open/floor/rogue/naturalstone,
/area/rogue/under/tomb)
"x" = (
/turf/open/transparent/openspace,
/area/rogue/under/tomb)
"y" = (
/mob/living/carbon/human/species/skeleton/npc,
/turf/open/floor/rogue/naturalstone,
/area/rogue/under/tomb)
"z" = (
/obj/structure/stairs/stone{
	dir = 4
	},
/turf/open/floor/rogue/naturalstone,
/area/rogue/under/tomb)
"A" = (
/obj/effect/dungeon_directional_helper/east,
/turf/open/floor/rogue/naturalstone,
/area/rogue/under/tomb)
"B" = (
/mob/living/carbon/human/species/skeleton/npc/bogguard,
/obj/effect/landmark/chest_or_mimic,
/obj/item/clothing/ring/silver,
/turf/open/floor/rogue/naturalstone,
/area/rogue/under/tomb)
"C" = (
/obj/item/clothing/shoes/roguetown/boots/leather/reinforced,
/turf/open/floor/rogue/naturalstone,
/area/rogue/under/tomb)
"D" = (
/obj/structure/stairs/stone,
/turf/open/floor/rogue/naturalstone,
/area/rogue/under/tomb)
"G" = (
/obj/item/clothing/head/roguetown/helmet/skullcap,
/turf/open/floor/rogue/naturalstone,
/area/rogue/under/tomb)
"H" = (
/obj/effect/landmark/chest_or_mimic,
/obj/item/lockpickring,
/obj/item/clothing/head/roguetown/helmet/leather/volfhelm,
/turf/open/floor/rogue/naturalstone,
/area/rogue/under/tomb)
"I" = (
/obj/effect/spawner/lootdrop/roguetown/dungeon/weapons,
/turf/open/floor/rogue/naturalstone,
/area/rogue/under/tomb)
"M" = (
/obj/item/rogueweapon/sword/iron,
/turf/open/floor/rogue/naturalstone,
/area/rogue/under/tomb)
"Q" = (
/obj/effect/spawner/lootdrop/roguetown/dungeon/weapons,
/mob/living/carbon/human/species/skeleton/npc,
/turf/open/floor/rogue/naturalstone,
/area/rogue/under/tomb)
"R" = (
/turf/open/floor/rogue/naturalstone,
/area/rogue/under/tomb)
"S" = (
/obj/effect/dungeon_directional_helper/west,
/turf/open/floor/rogue/naturalstone,
/area/rogue/under/tomb)
"U" = (
/obj/item/clothing/suit/roguetown/armor/leather/hide,
/turf/open/floor/rogue/naturalstone,
/area/rogue/under/tomb)
"X" = (
/obj/item/clothing/suit/roguetown/armor/gambeson,
/turf/open/floor/rogue/naturalstone,
/area/rogue/under/tomb)
"Y" = (
/obj/structure/stairs/stone{
	dir = 8
	},
/turf/open/floor/rogue/naturalstone,
/area/rogue/under/tomb)
"Z" = (
/obj/item/clothing/suit/roguetown/armor/plate/cuirass/fencer,
/turf/open/floor/rogue/naturalstone,
/area/rogue/under/tomb)

(1,1,1) = {"
a
a
a
a
a
a
a
t
R
S
R
D
a
a
a
a
a
a
a
a
"}
(2,1,1) = {"
a
a
a
a
a
a
a
t
R
R
R
D
a
a
a
a
a
a
a
a
"}
(3,1,1) = {"
a
a
a
a
a
a
a
a
a
a
a
a
a
a
a
a
a
a
a
a
"}
(4,1,1) = {"
a
a
a
a
a
a
R
R
R
R
R
R
R
R
a
a
a
a
a
a
"}
(5,1,1) = {"
a
a
a
a
a
R
R
R
R
R
Z
R
M
R
R
R
a
a
a
a
"}
(6,1,1) = {"
a
a
a
a
R
R
R
R
I
U
R
R
R
R
R
R
a
a
a
a
"}
(7,1,1) = {"
a
a
a
R
R
R
X
M
y
R
R
R
y
o
R
R
R
a
a
a
"}
(8,1,1) = {"
Y
Y
a
R
R
R
Q
R
o
C
y
R
R
M
k
I
R
a
Y
Y
"}
(9,1,1) = {"
R
R
a
R
R
R
G
R
R
i
m
n
R
o
R
R
R
a
R
R
"}
(10,1,1) = {"
u
R
a
R
y
R
c
R
c
m
B
s
y
R
R
y
R
a
R
e
"}
(11,1,1) = {"
R
R
a
R
R
R
y
R
R
H
l
m
R
R
R
R
R
a
R
R
"}
(12,1,1) = {"
R
R
a
R
R
R
R
p
y
R
y
R
R
y
R
R
R
a
R
R
"}
(13,1,1) = {"
z
z
a
R
R
R
R
R
R
R
R
R
R
R
R
R
r
a
z
z
"}
(14,1,1) = {"
a
a
a
a
R
R
R
R
R
I
q
R
c
R
I
R
R
a
a
a
"}
(15,1,1) = {"
a
a
a
a
R
R
M
y
R
R
R
y
o
R
R
R
a
a
a
a
"}
(16,1,1) = {"
a
a
a
a
a
R
R
R
R
M
R
R
I
R
M
a
a
a
a
a
"}
(17,1,1) = {"
a
a
a
a
a
a
R
R
R
R
R
R
R
a
a
a
a
a
a
a
"}
(18,1,1) = {"
a
a
a
a
a
a
a
a
a
a
a
a
a
a
a
a
a
a
a
a
"}
(19,1,1) = {"
a
a
a
a
a
a
a
t
R
R
R
D
a
a
a
a
a
a
a
a
"}
(20,1,1) = {"
a
a
a
a
a
a
a
t
R
A
R
D
a
a
a
a
a
a
a
a
"}

(1,1,2) = {"
a
a
a
a
R
R
t
x
x
R
x
x
D
R
a
a
a
a
a
a
"}
(2,1,2) = {"
a
a
a
R
R
R
t
x
x
R
x
x
D
R
R
R
R
a
a
a
"}
(3,1,2) = {"
a
a
R
R
R
R
R
R
R
R
R
R
R
R
R
R
R
R
a
a
"}
(4,1,2) = {"
a
a
R
R
R
R
x
x
x
R
x
x
x
x
R
R
R
R
a
a
"}
(5,1,2) = {"
a
R
R
R
R
x
x
x
x
R
x
x
x
x
x
x
R
R
R
a
"}
(6,1,2) = {"
R
R
R
R
x
x
x
x
x
R
x
x
x
x
x
x
R
R
R
R
"}
(7,1,2) = {"
Y
Y
R
x
x
x
x
x
x
R
x
x
x
x
x
x
x
R
Y
Y
"}
(8,1,2) = {"
x
x
R
x
x
x
x
x
x
R
x
x
x
x
x
x
x
R
x
x
"}
(9,1,2) = {"
x
x
R
x
x
x
x
x
x
R
x
x
x
x
x
x
x
R
x
x
"}
(10,1,2) = {"
R
R
R
R
R
R
R
R
R
R
R
R
R
R
R
R
R
R
R
R
"}
(11,1,2) = {"
R
R
R
R
R
R
R
R
R
R
R
R
R
R
R
R
R
R
R
R
"}
(12,1,2) = {"
x
x
R
x
x
x
x
x
x
R
x
x
x
x
x
x
x
R
x
x
"}
(13,1,2) = {"
x
x
R
x
x
x
x
x
x
R
x
x
x
x
x
x
x
R
x
x
"}
(14,1,2) = {"
z
z
R
R
x
x
x
x
x
R
x
x
x
x
x
x
x
R
z
z
"}
(15,1,2) = {"
R
R
R
R
x
x
x
x
x
R
x
x
x
x
x
x
R
R
R
R
"}
(16,1,2) = {"
a
R
R
R
R
x
x
x
x
R
x
x
x
x
x
R
R
R
R
a
"}
(17,1,2) = {"
a
a
R
R
R
R
x
x
x
R
x
x
x
R
R
R
R
R
a
a
"}
(18,1,2) = {"
a
a
a
R
R
R
R
R
R
R
R
R
R
R
R
R
R
a
a
a
"}
(19,1,2) = {"
a
a
a
a
R
R
t
x
x
R
x
x
D
R
R
R
a
a
a
a
"}
(20,1,2) = {"
a
a
a
a
a
R
t
x
x
R
x
x
D
R
R
a
a
a
a
a
"}
