//MAP CONVERTED BY dmm2tgm.py THIS HEADER COMMENT PREVENTS RECONVERSION, DO NOT REMOVE
"at" = (
/obj/effect/decal/cleanable/dirt/cobweb{
	dir = 8
	},
/obj/structure/bookcase,
/obj/item/book/random,
/turf/open/floor/rogue/ruinedwood/spiral,
/area/rogue/under/tomb/indoors/magic)
"bf" = (
/obj/effect/decal/cleanable/dirt/cobweb{
	dir = 4
	},
/turf/open/floor/rogue/ruinedwood/spiral,
/area/rogue/under/tomb/indoors/magic)
"bC" = (
/obj/effect/decal/cleanable/dirt/cobweb/cobweb2,
/obj/structure/bookcase,
/obj/item/book/random,
/obj/item/book/random,
/obj/item/book/random,
/obj/item/book/random,
/obj/item/book/random,
/obj/item/book/random,
/turf/open/floor/rogue/churchrough,
/area/rogue/under/tomb/indoors/magic)
"dd" = (
/obj/item/book/random,
/turf/open/floor/rogue/churchrough,
/area/rogue/under/tomb/indoors/magic)
"dX" = (
/obj/structure/bookcase,
/obj/item/book/random,
/obj/item/book/random,
/obj/item/book/random,
/obj/item/book/random,
/obj/item/book/random,
/turf/open/floor/rogue/churchrough,
/area/rogue/under/tomb/indoors/magic)
"et" = (
/obj/structure/fluff/railing/wood{
	dir = 4
	},
/turf/open/floor/rogue/ruinedwood/spiral,
/area/rogue/under/tomb/indoors/magic)
"fs" = (
/obj/effect/decal/cleanable/shreds,
/turf/open/floor/rogue/ruinedwood/spiral,
/area/rogue/under/tomb/indoors/magic)
"fT" = (
/obj/effect/dungeon_directional_helper/south,
/turf/open/floor/rogue/churchrough,
/area/rogue/under/tomb)
"gr" = (
/obj/effect/decal/cleanable/dirt/cobweb/cobweb2,
/turf/open/floor/rogue/churchrough,
/area/rogue/under/tomb/indoors/magic)
"hV" = (
/obj/effect/dungeon_directional_helper/north,
/turf/open/floor/rogue/churchrough,
/area/rogue/under/tomb)
"ir" = (
/obj/effect/decal/cleanable/dirt/cobweb,
/obj/structure/rack/rogue/shelf,
/turf/open/floor/rogue/churchrough,
/area/rogue/under/tomb/indoors/magic)
"iA" = (
/obj/structure/fluff/railing/wood{
	dir = 8
	},
/turf/open/floor/rogue/churchrough,
/area/rogue/under/tomb/indoors/magic)
"iX" = (
/obj/effect/decal/cleanable/debris/stony,
/obj/structure/fluff/railing/wood,
/turf/open/floor/rogue/churchrough,
/area/rogue/under/tomb/indoors/magic)
"kz" = (
/obj/structure/fluff/railing/wood{
	dir = 1
	},
/turf/open/floor/rogue/ruinedwood/spiral,
/area/rogue/under/tomb/indoors/magic)
"kH" = (
/obj/effect/decal/cleanable/debris/stony,
/obj/structure/fluff/railing/wood{
	dir = 8
	},
/turf/open/floor/rogue/churchrough,
/area/rogue/under/tomb/indoors/magic)
"lH" = (
/obj/structure/mineral_door/wood/violet,
/turf/open/floor/rogue/ruinedwood/spiral,
/area/rogue/under/tomb/indoors/magic)
"mm" = (
/obj/effect/decal/cleanable/shreds,
/obj/item/book/random,
/turf/open/floor/rogue/churchrough,
/area/rogue/under/tomb/indoors/magic)
"mA" = (
/turf/open/floor/rogue/churchrough,
/area/rogue/under/tomb)
"oc" = (
/obj/structure/fluff/railing/wood{
	dir = 1
	},
/turf/open/floor/rogue/churchrough,
/area/rogue/under/tomb/indoors/magic)
"oT" = (
/obj/effect/spawner/lootdrop/random_gem,
/turf/closed/wall/mineral/rogue/stonebrick,
/area/rogue/under/tomb/indoors/magic)
"qJ" = (
/obj/structure/stairs{
	dir = 4
	},
/turf/open/floor/rogue/ruinedwood,
/area/rogue/under/tomb/indoors/magic)
"sX" = (
/obj/effect/decal/cleanable/dirt/cobweb{
	dir = 4
	},
/obj/structure/bookcase,
/turf/open/floor/rogue/churchrough,
/area/rogue/under/tomb/indoors/magic)
"tg" = (
/obj/structure/fluff/railing/wood,
/turf/open/floor/rogue/churchrough,
/area/rogue/under/tomb/indoors/magic)
"tr" = (
/obj/structure/rack/rogue/shelf,
/obj/effect/decal/cleanable/dirt/cobweb/cobweb2,
/turf/open/floor/rogue/ruinedwood/spiral,
/area/rogue/under/tomb/indoors/magic)
"tQ" = (
/obj/structure/bookcase,
/obj/item/book/random,
/turf/open/floor/rogue/ruinedwood/spiral,
/area/rogue/under/tomb/indoors/magic)
"tY" = (
/obj/effect/decal/cleanable/debris/stony,
/obj/structure/fluff/railing/wood{
	dir = 1
	},
/turf/open/floor/rogue/churchrough,
/area/rogue/under/tomb/indoors/magic)
"ud" = (
/turf/open/floor/rogue/churchrough,
/area/rogue/under/tomb/indoors/magic)
"uo" = (
/obj/structure/bookcase,
/obj/item/book/random,
/turf/open/floor/rogue/churchrough,
/area/rogue/under/tomb/indoors/magic)
"uW" = (
/obj/effect/decal/cleanable/dirt/cobweb{
	dir = 8
	},
/turf/open/floor/rogue/churchrough,
/area/rogue/under/tomb/indoors/magic)
"vx" = (
/turf/open/transparent/openspace,
/area/rogue/under/tomb/indoors/magic)
"vI" = (
/obj/item/natural/rock,
/turf/closed/wall/mineral/rogue/stonebrick,
/area/rogue/under/tomb/indoors/magic)
"vV" = (
/turf/closed/mineral/rogue/bedrock,
/area/rogue/under/tomb)
"wu" = (
/obj/effect/decal/cleanable/dirt,
/turf/open/floor/rogue/ruinedwood/spiral,
/area/rogue/under/tomb/indoors/magic)
"xc" = (
/obj/structure/bookcase,
/obj/item/book/random,
/obj/item/book/random,
/obj/item/book/random,
/obj/item/book/random,
/obj/item/book/random,
/obj/item/book/random,
/obj/item/book/random,
/obj/item/book/random,
/obj/item/book/random,
/turf/open/floor/rogue/churchrough,
/area/rogue/under/tomb/indoors/magic)
"xi" = (
/obj/structure/bookcase,
/obj/item/book/random,
/obj/item/book/random,
/obj/item/book/random,
/obj/item/book/random,
/obj/item/book/random,
/obj/item/book/random,
/turf/open/floor/rogue/churchrough,
/area/rogue/under/tomb/indoors/magic)
"yd" = (
/turf/open/floor/rogue/ruinedwood/spiral,
/area/rogue/under/tomb)
"yG" = (
/obj/effect/decal/cleanable/dirt/cobweb,
/turf/open/floor/rogue/ruinedwood/spiral,
/area/rogue/under/tomb/indoors/magic)
"zX" = (
/obj/effect/dungeon_directional_helper/west,
/turf/open/floor/rogue/churchrough,
/area/rogue/under/tomb)
"Ak" = (
/obj/structure/bookcase,
/obj/item/book/random,
/obj/item/book/random,
/turf/open/floor/rogue/churchrough,
/area/rogue/under/tomb/indoors/magic)
"Ay" = (
/obj/effect/decal/remains/bigrat,
/obj/item/book/random,
/turf/open/floor/rogue/ruinedwood/spiral,
/area/rogue/under/tomb/indoors/magic)
"BG" = (
/obj/structure/fluff/railing/wood,
/turf/open/floor/rogue/ruinedwood/spiral,
/area/rogue/under/tomb/indoors/magic)
"DF" = (
/obj/structure/bookcase,
/obj/item/book/random,
/obj/item/book/random,
/obj/item/book/random,
/turf/open/floor/rogue/ruinedwood/spiral,
/area/rogue/under/tomb/indoors/magic)
"Ea" = (
/turf/open/floor/rogue/ruinedwood,
/area/rogue/under/tomb/indoors/magic)
"Fm" = (
/obj/structure/bookcase,
/obj/item/book/random,
/obj/item/book/random,
/obj/item/book/random,
/turf/open/floor/rogue/churchrough,
/area/rogue/under/tomb/indoors/magic)
"Fr" = (
/obj/machinery/light/rogue/candle/blue/l,
/turf/open/transparent/openspace,
/area/rogue/under/tomb/indoors/magic)
"FF" = (
/turf/open/floor/rogue/ruinedwood/spiral,
/area/rogue/under/tomb/indoors/magic)
"GR" = (
/obj/structure/stairs{
	dir = 1
	},
/turf/open/floor/rogue/ruinedwood,
/area/rogue/under/tomb/indoors/magic)
"IM" = (
/obj/structure/rack/rogue/shelf,
/obj/effect/decal/cleanable/shreds,
/turf/open/floor/rogue/churchrough,
/area/rogue/under/tomb/indoors/magic)
"JT" = (
/obj/effect/decal/cleanable/dirt,
/obj/structure/fluff/railing/wood{
	dir = 4
	},
/turf/open/floor/rogue/ruinedwood/spiral,
/area/rogue/under/tomb/indoors/magic)
"Kl" = (
/obj/structure/stairs,
/turf/open/floor/rogue/ruinedwood,
/area/rogue/under/tomb/indoors/magic)
"Lb" = (
/obj/effect/decal/cleanable/dirt,
/turf/open/floor/rogue/churchrough,
/area/rogue/under/tomb/indoors/magic)
"Lv" = (
/obj/structure/fluff/railing/wood{
	dir = 8
	},
/turf/open/floor/rogue/ruinedwood/spiral,
/area/rogue/under/tomb/indoors/magic)
"LF" = (
/obj/structure/bookcase,
/obj/item/book/random,
/obj/item/book/random,
/turf/open/floor/rogue/ruinedwood/spiral,
/area/rogue/under/tomb/indoors/magic)
"LK" = (
/obj/effect/decal/remains/bigrat,
/turf/open/floor/rogue/churchrough,
/area/rogue/under/tomb/indoors/magic)
"Nr" = (
/obj/effect/decal/cleanable/dirt/cobweb,
/obj/structure/rack/rogue/shelf,
/turf/open/floor/rogue/ruinedwood/spiral,
/area/rogue/under/tomb/indoors/magic)
"On" = (
/obj/effect/dungeon_directional_helper/east,
/turf/open/floor/rogue/churchrough,
/area/rogue/under/tomb)
"Qb" = (
/obj/structure/stairs{
	dir = 8
	},
/turf/open/floor/rogue/ruinedwood,
/area/rogue/under/tomb/indoors/magic)
"Ql" = (
/obj/effect/decal/cleanable/dirt,
/obj/structure/fluff/railing/wood,
/turf/open/floor/rogue/churchrough,
/area/rogue/under/tomb/indoors/magic)
"Rk" = (
/obj/structure/mineral_door/wood/violet,
/turf/open/floor/rogue/churchrough,
/area/rogue/under/tomb/indoors/magic)
"Sj" = (
/obj/effect/decal/cleanable/debris/stony,
/obj/structure/fluff/railing/wood,
/turf/open/floor/rogue/ruinedwood/spiral,
/area/rogue/under/tomb/indoors/magic)
"Tb" = (
/obj/machinery/light/rogue/candle/blue/r,
/obj/effect/decal/cleanable/debris/stony,
/turf/open/floor/rogue/churchrough,
/area/rogue/under/tomb/indoors/magic)
"TP" = (
/turf/closed/wall/mineral/rogue/stonebrick,
/area/rogue/under/tomb/indoors/magic)
"UB" = (
/obj/effect/decal/cleanable/debris/stony,
/obj/structure/fluff/railing/wood{
	dir = 1
	},
/turf/open/floor/rogue/ruinedwood/spiral,
/area/rogue/under/tomb/indoors/magic)
"Vw" = (
/turf/closed/wall/mineral/rogue/wooddark,
/area/rogue/under/tomb/indoors/magic)
"VA" = (
/obj/effect/decal/remains/bigrat,
/obj/item/book/random,
/turf/open/floor/rogue/churchrough,
/area/rogue/under/tomb/indoors/magic)
"Xq" = (
/obj/effect/decal/cleanable/shreds,
/obj/structure/fluff/railing/wood{
	dir = 4
	},
/turf/open/floor/rogue/ruinedwood/spiral,
/area/rogue/under/tomb/indoors/magic)
"XF" = (
/obj/effect/decal/cleanable/dirt,
/obj/effect/decal/cleanable/debris/stony,
/turf/open/floor/rogue/churchrough,
/area/rogue/under/tomb/indoors/magic)
"XX" = (
/obj/structure/bookcase,
/obj/item/book/random,
/obj/item/book/random,
/obj/item/book/random,
/obj/item/book/random,
/obj/item/book/random,
/obj/item/book/random,
/obj/item/book/random,
/obj/item/book/random,
/obj/item/book/random,
/obj/item/book/random,
/obj/item/book/random,
/turf/open/floor/rogue/churchrough,
/area/rogue/under/tomb/indoors/magic)
"Yx" = (
/obj/effect/decal/cleanable/debris/stony,
/turf/open/floor/rogue/churchrough,
/area/rogue/under/tomb/indoors/magic)
"ZC" = (
/obj/structure/bookcase,
/obj/item/book/random,
/obj/item/book/random,
/obj/item/book/random,
/obj/item/book/random,
/obj/item/book/random,
/turf/open/floor/rogue/ruinedwood/spiral,
/area/rogue/under/tomb/indoors/magic)

(1,1,1) = {"
vV
vV
vV
vV
vV
mA
mA
zX
mA
mA
vV
vV
vV
vV
vV
"}
(2,1,1) = {"
vV
TP
TP
TP
TP
TP
Rk
TP
Rk
TP
TP
TP
TP
TP
vV
"}
(3,1,1) = {"
vV
TP
TP
vI
ir
dX
ud
ud
ud
Yx
XX
TP
TP
TP
vV
"}
(4,1,1) = {"
vV
TP
TP
Lb
dd
xc
ud
mm
Yx
dX
dd
ud
TP
TP
vV
"}
(5,1,1) = {"
vV
TP
uo
Lb
Lb
dX
Yx
ud
ud
uo
Lb
Lb
sX
TP
vV
"}
(6,1,1) = {"
mA
TP
xi
XF
ud
ud
ud
ud
ud
Lb
Lb
LK
Fm
TP
mA
"}
(7,1,1) = {"
mA
Rk
ud
Yx
tg
Ea
Ea
Ea
Vw
Vw
ud
ud
ud
Rk
mA
"}
(8,1,1) = {"
hV
TP
ud
ud
tg
qJ
qJ
TP
Qb
Qb
oc
Yx
ud
TP
fT
"}
(9,1,1) = {"
mA
Rk
ud
dd
iX
Ea
Ea
Kl
Ea
Ea
tY
ud
ud
Rk
mA
"}
(10,1,1) = {"
mA
TP
uo
Lb
Ql
Ea
Ea
Kl
Ea
Ea
oc
ud
dX
TP
mA
"}
(11,1,1) = {"
vV
TP
bC
VA
Lb
kH
iA
iA
iA
iA
Lb
ud
Ak
TP
vV
"}
(12,1,1) = {"
vV
TP
TP
gr
Yx
uo
Yx
ud
ud
XX
Lb
uW
TP
TP
vV
"}
(13,1,1) = {"
vV
TP
TP
TP
IM
Ak
ud
Tb
ud
xi
uW
TP
TP
TP
vV
"}
(14,1,1) = {"
vV
TP
TP
TP
TP
TP
Rk
TP
Rk
TP
TP
TP
TP
TP
vV
"}
(15,1,1) = {"
vV
vV
vV
vV
vV
mA
mA
On
mA
mA
vV
vV
vV
vV
vV
"}

(1,1,2) = {"
vV
vV
vV
vV
vV
yd
yd
yd
yd
yd
vV
vV
vV
vV
vV
"}
(2,1,2) = {"
vV
TP
TP
TP
TP
TP
vx
TP
lH
TP
TP
TP
TP
TP
vV
"}
(3,1,2) = {"
vV
TP
TP
TP
Nr
ZC
vx
Fr
FF
FF
bf
TP
TP
TP
vV
"}
(4,1,2) = {"
vV
TP
TP
yG
vx
tQ
FF
vx
vx
DF
FF
vx
TP
TP
vV
"}
(5,1,2) = {"
vV
TP
LF
Ay
FF
Xq
et
vx
et
JT
wu
FF
FF
TP
vV
"}
(6,1,2) = {"
yd
TP
tQ
vx
BG
Ea
Ea
GR
Ea
Ea
kz
vx
vx
TP
yd
"}
(7,1,2) = {"
yd
lH
wu
FF
Sj
Ea
Ea
GR
Qb
Qb
kz
vx
FF
lH
yd
"}
(8,1,2) = {"
yd
TP
FF
FF
BG
qJ
qJ
TP
vx
vx
kz
vx
vx
TP
yd
"}
(9,1,2) = {"
yd
lH
wu
FF
FF
Ea
Ea
vx
vx
vx
UB
FF
FF
lH
yd
"}
(10,1,2) = {"
yd
TP
FF
wu
BG
Ea
Ea
vx
vx
vx
kz
FF
DF
TP
yd
"}
(11,1,2) = {"
vV
TP
vx
vx
vx
vx
vx
Lv
Lv
Lv
fs
FF
at
TP
vV
"}
(12,1,2) = {"
vV
TP
TP
vx
vx
vx
vx
vx
FF
vx
vx
vx
TP
TP
vV
"}
(13,1,2) = {"
vV
TP
TP
oT
tr
FF
vx
FF
wu
FF
FF
TP
TP
TP
vV
"}
(14,1,2) = {"
vV
TP
TP
TP
TP
TP
vx
TP
lH
TP
TP
TP
TP
TP
vV
"}
(15,1,2) = {"
vV
vV
vV
vV
vV
yd
yd
yd
yd
yd
vV
vV
vV
vV
vV
"}
