//MAP CONVERTED BY dmm2tgm.py THIS HEADER COMMENT PREVENTS RECONVERSION, DO NOT REMOVE
"af" = (
/obj/item/organ/brain,
/turf/open/floor/rogue/ruinedwood,
/area/rogue/under/tomb)
"ai" = (
/obj/item/rogueweapon/huntingknife/idagger/silver,
/obj/item/natural/stone,
/obj/item/natural/stone{
	pixel_y = -6;
	pixel_x = 4
	},
/obj/item/natural/stone{
	pixel_y = -12;
	pixel_x = -7
	},
/obj/item/natural/stone{
	pixel_y = 4;
	pixel_x = -7
	},
/obj/item/natural/stone{
	pixel_y = 7;
	pixel_x = 11
	},
/obj/effect/decal/cleanable/blood,
/turf/open/floor/rogue/cobblerock,
/area/rogue/under/tomb)
"bT" = (
/obj/structure/closet/crate/chest/old_crate,
/obj/item/rogueweapon/sword/rapier/dec,
/obj/item/clothing/suit/roguetown/armor/plate/cuirass,
/obj/item/clothing/mask/rogue/facemask,
/obj/item/organ/heart,
/obj/effect/decal/cleanable/blood,
/obj/effect/spawner/lootdrop/roguetown/dungeon/food,
/turf/open/floor/rogue/herringbone,
/area/rogue/under/tomb)
"bU" = (
/mob/living/carbon/human/species/skeleton/npc/bogguard,
/obj/structure/bed/rogue/inn/hay,
/obj/item/organ/eyes,
/obj/effect/decal/cleanable/blood,
/obj/effect/decal/cleanable/blood/gibs/old,
/turf/open/floor/rogue/herringbone,
/area/rogue/under/tomb)
"cP" = (
/obj/effect/decal/cleanable/dirt/dust,
/obj/structure/bed/rogue/inn/hay,
/turf/open/floor/rogue/cobble,
/area/rogue/under/tomb)
"eB" = (
/obj/effect/decal/cleanable/blood,
/mob/living/carbon/human/species/orc/npc/footsoldier,
/turf/open/floor/rogue/ruinedwood,
/area/rogue/under/tomb)
"eI" = (
/obj/effect/decal/cleanable/blood,
/turf/open/floor/rogue/dirt/road,
/area/rogue/under/tomb)
"gg" = (
/obj/structure/table/wood/crafted,
/obj/item/natural/cloth,
/obj/item/natural/cloth{
	pixel_y = 5;
	pixel_x = -7
	},
/turf/open/floor/rogue/cobble,
/area/rogue/under/tomb)
"gm" = (
/obj/structure/fermentation_keg/random/water,
/obj/item/reagent_containers/glass/bowl,
/turf/open/floor/rogue/cobble,
/area/rogue/under/tomb)
"gU" = (
/obj/item/organ/lungs,
/turf/open/floor/rogue/dirt/road,
/area/rogue/under/tomb)
"kp" = (
/obj/effect/decal/cleanable/blood,
/turf/open/floor/rogue/herringbone,
/area/rogue/under/tomb)
"lP" = (
/turf/open/floor/rogue/dirt/road,
/area/rogue/under/tomb)
"mb" = (
/obj/structure/barricade,
/obj/structure/barricade/crude,
/turf/open/floor/rogue/cobblerock,
/area/rogue/under/tomb)
"mo" = (
/obj/item/restraints/legcuffs/beartrap/armed,
/obj/item/ingot/gold,
/turf/open/floor/rogue/cobblerock,
/area/rogue/under/tomb)
"mJ" = (
/obj/effect/spawner/lootdrop/roguetown/dungeon/food,
/turf/open/floor/rogue/dirt/road,
/area/rogue/under/tomb)
"oy" = (
/obj/structure/mineral_door/wood,
/turf/open/floor/rogue/cobblerock,
/area/rogue/under/tomb)
"oD" = (
/obj/item/organ/brain,
/obj/effect/decal/cleanable/blood,
/turf/open/floor/rogue/ruinedwood,
/area/rogue/under/tomb)
"pp" = (
/obj/effect/dungeon_directional_helper/north,
/turf/open/floor/rogue/cobblerock,
/area/rogue/under/tomb)
"px" = (
/obj/item/ingot/gold,
/turf/open/floor/rogue/ruinedwood,
/area/rogue/under/tomb)
"pz" = (
/obj/effect/decal/cleanable/dirt/dust,
/turf/open/floor/rogue/blocks,
/area/rogue/under/tomb)
"pY" = (
/obj/item/reagent_containers/glass/bucket/pot,
/obj/structure/table/wood/crafted,
/turf/open/floor/rogue/blocks,
/area/rogue/under/tomb)
"rl" = (
/turf/open/floor/rogue/blocks,
/area/rogue/under/tomb)
"sO" = (
/obj/structure/bed/rogue/shit,
/obj/effect/decal/cleanable/dirt/dust,
/obj/effect/decal/cleanable/blood,
/obj/effect/decal/cleanable/blood/gibs/old,
/mob/living/carbon/human/species/skeleton/npc/mediumspread,
/turf/open/floor/rogue/blocks,
/area/rogue/under/tomb)
"to" = (
/obj/structure/bed/rogue/inn/hay,
/obj/effect/spawner/lootdrop/roguetown/dungeon/food,
/obj/effect/decal/cleanable/blood/gibs/old,
/mob/living/carbon/human/species/skeleton/npc/mediumspread,
/turf/open/floor/rogue/cobble,
/area/rogue/under/tomb)
"tJ" = (
/turf/closed/wall/mineral/rogue/tent,
/area/rogue/under/tomb)
"uV" = (
/obj/item/clothing/neck/roguetown/psicross/silver,
/turf/open/floor/rogue/ruinedwood,
/area/rogue/under/tomb)
"xG" = (
/turf/closed/mineral/rogue/bedrock,
/area/rogue/under/tomb)
"yE" = (
/obj/effect/decal/cleanable/blood,
/turf/open/floor/rogue/cobblerock,
/area/rogue/under/tomb)
"zd" = (
/obj/item/restraints/legcuffs/beartrap/armed,
/obj/item/reagent_containers/food/snacks/rogue/pie/cooked/apple,
/turf/open/floor/rogue/ruinedwood,
/area/rogue/under/tomb)
"As" = (
/turf/closed/wall/mineral/rogue/wooddark,
/area/rogue/under/tomb)
"Be" = (
/obj/item/reagent_containers/glass/bottle,
/turf/open/floor/rogue/cobblerock,
/area/rogue/under/tomb)
"Ed" = (
/obj/effect/spawner/lootdrop/roguetown/dungeon/food,
/obj/effect/decal/cleanable/blood,
/turf/open/floor/rogue/ruinedwood,
/area/rogue/under/tomb)
"FU" = (
/obj/item/organ/tongue,
/turf/open/floor/rogue/herringbone,
/area/rogue/under/tomb)
"Ga" = (
/obj/effect/dungeon_directional_helper/east,
/turf/open/floor/rogue/dirt/road,
/area/rogue/under/tomb)
"Hf" = (
/mob/living/carbon/human/species/orc/npc/footsoldier,
/turf/open/floor/rogue/dirt/road,
/area/rogue/under/tomb)
"Ig" = (
/obj/item/organ/lungs,
/turf/open/floor/rogue/ruinedwood,
/area/rogue/under/tomb)
"Kb" = (
/obj/effect/decal/cleanable/blood,
/mob/living/carbon/human/species/orc/npc/footsoldier,
/turf/open/floor/rogue/dirt/road,
/area/rogue/under/tomb)
"Kr" = (
/obj/item/paper/scroll,
/obj/structure/table/wood/crafted,
/obj/item/natural/feather,
/turf/open/floor/rogue/cobblerock,
/area/rogue/under/tomb)
"KI" = (
/obj/structure/table/wood/crafted,
/obj/item/needle,
/turf/open/floor/rogue/cobble,
/area/rogue/under/tomb)
"KJ" = (
/turf/open/floor/rogue/herringbone,
/area/rogue/under/tomb)
"LW" = (
/obj/effect/dungeon_directional_helper/west,
/turf/open/floor/rogue/dirt/road,
/area/rogue/under/tomb)
"MI" = (
/obj/effect/decal/cleanable/dirt/dust,
/turf/open/floor/rogue/cobble,
/area/rogue/under/tomb)
"Nl" = (
/obj/effect/decal/cleanable/blood,
/turf/open/floor/rogue/ruinedwood,
/area/rogue/under/tomb)
"NR" = (
/obj/effect/dungeon_directional_helper/south,
/turf/open/floor/rogue/cobblerock,
/area/rogue/under/tomb)
"Oo" = (
/obj/effect/spawner/lootdrop/roguetown/dungeon/food,
/obj/item/organ/heart,
/obj/effect/decal/cleanable/blood,
/turf/open/floor/rogue/ruinedwood,
/area/rogue/under/tomb)
"Qs" = (
/turf/open/floor/rogue/ruinedwood,
/area/rogue/under/tomb)
"RT" = (
/obj/structure/table/wood/crafted,
/obj/item/rogueweapon/huntingknife{
	pixel_y = 3;
	pixel_x = -5
	},
/obj/item/reagent_containers/food/snacks/rogue/meat/mince/beef{
	pixel_x = 6;
	pixel_y = 8
	},
/obj/item/reagent_containers/food/snacks/rogue/meat/salami{
	pixel_y = -1;
	pixel_x = -5
	},
/obj/effect/spawner/lootdrop/roguetown/dungeon/food,
/obj/effect/spawner/lootdrop/roguetown/dungeon/food,
/turf/open/floor/rogue/blocks,
/area/rogue/under/tomb)
"Tu" = (
/obj/item/reagent_containers/glass/bottle/rogue/beer/apfelweinheim,
/turf/open/floor/rogue/cobblerock,
/area/rogue/under/tomb)
"Tw" = (
/obj/structure/bed/rogue/shit,
/mob/living/carbon/human/species/skeleton/npc/mediumspread,
/turf/open/floor/rogue/cobblerock,
/area/rogue/under/tomb)
"TS" = (
/obj/item/clothing/mask/rogue/facemask/goldmask,
/turf/open/floor/rogue/ruinedwood,
/area/rogue/under/tomb)
"Ud" = (
/turf/open/floor/rogue/cobble,
/area/rogue/under/tomb)
"Xw" = (
/obj/machinery/light/rogue/hearth,
/turf/open/floor/rogue/blocks,
/area/rogue/under/tomb)
"XA" = (
/obj/item/organ/eyes,
/turf/open/floor/rogue/dirt/road,
/area/rogue/under/tomb)
"Yz" = (
/obj/item/organ/heart,
/obj/effect/decal/cleanable/blood,
/turf/open/floor/rogue/dirt/road,
/area/rogue/under/tomb)
"YR" = (
/obj/effect/decal/cleanable/blood/footprints{
	dir = 4
	},
/turf/open/floor/rogue/cobblerock,
/area/rogue/under/tomb)
"Zv" = (
/turf/open/floor/rogue/cobblerock,
/area/rogue/under/tomb)

(1,1,1) = {"
xG
xG
xG
xG
xG
LW
Zv
xG
xG
xG
xG
xG
"}
(2,1,1) = {"
xG
KI
MI
Ud
oy
Zv
lP
xG
Tu
Be
Kr
xG
"}
(3,1,1) = {"
xG
gg
Ud
gm
As
lP
Zv
xG
Zv
Zv
Tu
xG
"}
(4,1,1) = {"
xG
cP
Ud
to
xG
Zv
lP
xG
mb
Tw
ai
xG
"}
(5,1,1) = {"
xG
xG
oy
xG
xG
lP
Zv
As
oy
As
xG
xG
"}
(6,1,1) = {"
Zv
lP
lP
Zv
Zv
lP
Zv
Zv
YR
lP
lP
Zv
"}
(7,1,1) = {"
pp
Zv
Zv
lP
Zv
Zv
lP
Zv
lP
lP
Zv
NR
"}
(8,1,1) = {"
xG
xG
xG
xG
xG
Zv
lP
As
xG
xG
xG
xG
"}
(9,1,1) = {"
xG
pY
Xw
pz
As
Zv
Zv
oy
kp
tJ
bU
xG
"}
(10,1,1) = {"
xG
sO
rl
rl
oy
lP
Zv
xG
KJ
FU
kp
xG
"}
(11,1,1) = {"
xG
RT
pz
rl
xG
lP
Zv
xG
kp
KJ
bT
xG
"}
(12,1,1) = {"
xG
xG
xG
xG
xG
Ga
lP
xG
xG
xG
xG
xG
"}

(1,1,2) = {"
xG
xG
xG
xG
Zv
Zv
Zv
Zv
xG
xG
xG
xG
"}
(2,1,2) = {"
xG
Hf
Ed
xG
xG
lP
lP
xG
xG
XA
eB
xG
"}
(3,1,2) = {"
xG
oD
Qs
lP
xG
Zv
Zv
xG
lP
lP
Ed
xG
"}
(4,1,2) = {"
xG
xG
af
lP
Zv
Zv
lP
Zv
Nl
XA
xG
xG
"}
(5,1,2) = {"
Zv
xG
xG
Zv
Qs
mo
Qs
Zv
eI
xG
xG
lP
"}
(6,1,2) = {"
lP
lP
Zv
lP
Zv
Qs
TS
zd
Qs
Zv
Zv
Zv
"}
(7,1,2) = {"
Zv
Zv
Zv
Zv
Qs
Qs
uV
Qs
Zv
Zv
lP
Zv
"}
(8,1,2) = {"
Zv
xG
xG
lP
yE
px
Zv
Qs
lP
xG
xG
Zv
"}
(9,1,2) = {"
xG
xG
Ig
lP
lP
Zv
lP
lP
Zv
eI
xG
xG
"}
(10,1,2) = {"
xG
mJ
Nl
lP
xG
Zv
Zv
xG
Oo
Qs
Yz
xG
"}
(11,1,2) = {"
xG
Kb
gU
xG
xG
lP
Zv
xG
xG
lP
Hf
xG
"}
(12,1,2) = {"
xG
xG
xG
xG
Zv
Zv
lP
Zv
xG
xG
xG
xG
"}
