//MAP CONVERTED BY dmm2tgm.py THIS HEADER COMMENT PREVENTS RECONVERSION, DO NOT REMOVE
"c" = (
/obj/effect/dungeon_directional_helper/south,
/turf/open/floor/rogue/naturalstone,
/area/rogue/under/tomb/cave)
"e" = (
/turf/open/transparent/openspace,
/area/rogue/under/tomb/cave)
"f" = (
/turf/open/floor/rogue/ruinedwood/turned,
/area/rogue/under/tomb/indoors)
"h" = (
/obj/item/flashlight/flare/torch/lantern,
/obj/structure/table/wood{
	icon_state = "tablewood1"
	},
/turf/open/floor/rogue/ruinedwood/turned,
/area/rogue/under/tomb/indoors)
"j" = (
/obj/structure/ladder/unbreakable,
/turf/open/floor/rogue/ruinedwood/turned,
/area/rogue/under/tomb/cave)
"k" = (
/obj/effect/spawner/lootdrop/roguetown/dungeon/food,
/obj/structure/table/wood{
	icon_state = "tablewood1"
	},
/turf/open/floor/rogue/ruinedwood/turned,
/area/rogue/under/tomb/indoors)
"m" = (
/obj/structure/table/wood{
	icon_state = "tablewood1"
	},
/turf/open/floor/rogue/ruinedwood/turned,
/area/rogue/under/tomb/indoors)
"o" = (
/turf/open/floor/rogue/naturalstone,
/area/rogue/under/tomb/cave)
"p" = (
/obj/structure/wallladder{
	dir = 8
	},
/turf/open/floor/rogue/naturalstone,
/area/rogue/under/tomb/cave)
"s" = (
/obj/effect/decal/remains/human{
	pixel_y = 12
	},
/obj/structure/bed/rogue/shit,
/turf/open/floor/rogue/ruinedwood/turned,
/area/rogue/under/tomb/indoors)
"t" = (
/turf/closed/wall/mineral/rogue/wooddark/slitted,
/area/rogue/under/tomb/indoors)
"v" = (
/turf/closed/mineral/rogue/bedrock,
/area/rogue/under/tomb/indoors)
"w" = (
/obj/effect/dungeon_directional_helper/north,
/turf/open/floor/rogue/naturalstone,
/area/rogue/under/tomb/cave)
"y" = (
/obj/machinery/light/rogue/firebowl,
/turf/open/floor/rogue/ruinedwood/turned,
/area/rogue/under/tomb/cave)
"z" = (
/obj/structure/mineral_door/bars,
/turf/open/floor/rogue/ruinedwood/turned,
/area/rogue/under/tomb/indoors)
"B" = (
/turf/open/floor/rogue/ruinedwood/turned,
/area/rogue/under/tomb/cave)
"C" = (
/obj/structure/ladder/unbreakable,
/turf/open/floor/rogue/ruinedwood/turned,
/area/rogue/under/tomb/indoors)
"D" = (
/obj/structure/fluff/walldeco/vinez,
/turf/closed/wall/mineral/rogue/wooddark/window,
/area/rogue/under/tomb/indoors)
"G" = (
/turf/open/floor/rogue/twig,
/area/rogue/under/tomb/cave)
"I" = (
/turf/closed/wall/mineral/rogue/wooddark/slitted,
/area/rogue/under/tomb/cave)
"M" = (
/obj/structure/roguerock,
/turf/open/floor/rogue/naturalstone,
/area/rogue/under/tomb/cave)
"R" = (
/obj/effect/dungeon_directional_helper/west,
/turf/open/floor/rogue/naturalstone,
/area/rogue/under/tomb/cave)
"S" = (
/turf/open/floor/rogue/rooftop/green,
/area/rogue/under/tomb/cave)
"U" = (
/obj/item/natural/rock/random,
/turf/open/floor/rogue/naturalstone,
/area/rogue/under/tomb/cave)
"W" = (
/turf/closed/mineral/rogue/bedrock,
/area/rogue/under/tomb/cave)
"X" = (
/obj/structure/fluff/walldeco/vinez/offset,
/turf/open/floor/rogue/naturalstone,
/area/rogue/under/tomb/cave)
"Z" = (
/turf/open/floor/rogue/rooftop/green{
	dir = 8
	},
/area/rogue/under/tomb/cave)

(1,1,1) = {"
W
W
W
W
W
W
o
R
o
o
W
W
W
W
W
"}
(2,1,1) = {"
W
W
W
W
W
o
U
o
o
o
W
W
W
W
W
"}
(3,1,1) = {"
W
W
W
W
o
o
o
o
U
o
o
W
W
W
W
"}
(4,1,1) = {"
W
W
W
o
o
U
o
o
o
o
o
o
W
W
W
"}
(5,1,1) = {"
W
W
W
W
W
o
o
U
o
I
o
o
o
W
W
"}
(6,1,1) = {"
W
W
W
W
W
o
o
o
o
o
o
U
o
W
W
"}
(7,1,1) = {"
W
W
W
W
I
U
o
o
o
o
o
o
o
o
o
"}
(8,1,1) = {"
o
o
o
M
o
o
o
o
I
o
o
o
o
o
c
"}
(9,1,1) = {"
w
o
o
o
o
o
o
o
p
o
W
W
U
o
o
"}
(10,1,1) = {"
o
o
o
o
o
o
o
o
o
o
W
o
o
o
W
"}
(11,1,1) = {"
v
t
t
D
t
z
t
X
o
W
W
o
W
W
W
"}
(12,1,1) = {"
v
f
f
f
f
f
t
o
o
o
W
W
W
W
W
"}
(13,1,1) = {"
v
C
f
f
f
f
t
o
W
W
W
W
W
W
W
"}
(14,1,1) = {"
v
f
k
h
m
s
t
W
W
W
W
W
W
W
W
"}
(15,1,1) = {"
v
v
v
v
v
v
v
W
W
W
W
W
W
W
W
"}

(1,1,2) = {"
W
W
W
W
W
W
o
o
o
o
W
W
W
W
W
"}
(2,1,2) = {"
W
W
W
W
W
e
e
e
G
G
W
W
W
W
W
"}
(3,1,2) = {"
W
W
W
W
e
e
e
e
G
G
e
W
W
W
W
"}
(4,1,2) = {"
W
W
W
e
e
e
e
e
e
G
e
e
W
W
W
"}
(5,1,2) = {"
W
W
W
W
W
e
e
e
G
G
e
e
e
W
W
"}
(6,1,2) = {"
W
W
W
W
W
e
e
e
G
e
e
e
e
W
W
"}
(7,1,2) = {"
W
W
W
W
G
G
G
G
G
G
G
G
o
o
o
"}
(8,1,2) = {"
o
G
G
G
G
e
G
G
G
e
G
G
o
o
o
"}
(9,1,2) = {"
o
e
e
e
e
e
e
e
e
e
o
o
M
o
o
"}
(10,1,2) = {"
o
e
e
e
e
e
e
e
e
e
W
e
e
e
W
"}
(11,1,2) = {"
W
Z
Z
Z
Z
Z
I
e
e
W
W
e
W
W
W
"}
(12,1,2) = {"
W
B
B
B
B
B
S
e
e
e
W
W
W
W
W
"}
(13,1,2) = {"
W
j
B
B
B
B
S
e
W
W
W
W
W
W
W
"}
(14,1,2) = {"
W
y
B
B
B
B
S
W
W
W
W
W
W
W
W
"}
(15,1,2) = {"
W
W
W
W
W
W
W
W
W
W
W
W
W
W
W
"}
